a4ded	afforded
a4din	affording
abhorrd	abhorred
abhorrin	abhorring
abidin	abiding
abolishd	abolished
abolishin	abolishing
abortd	aborted
abortin	aborting
aboundin	abounding
abridgd	abridged
abridgin	abridging
abrog8d	abrogated
abrogatin	abrogating
abscondin	absconding
abseild	abseiled
abseilin	abseiling
absentd	absented
absentin	absenting
absolvd	absolved
absolvin	absolving
absorbd	absorbed
absorbin	absorbing
abstaind	abstained
abstainin	abstaining
abstractd	abstracted
abstractin	abstracting
abt	about
abt2	about to
abusd	abused
abusin	abusing
abuttd	abutted
abuttin	abutting
abv8	abbreviate
accmmd8d	accommodated
accmmdatin	accommodating
accmpnyd	accompanied
accmpnyin	accompanying
accomplishd	accomplished
accomplishin	accomplishing
accountd	accounted
accountin	accounting
accountin	accounting
accreditd	accredited
accreditin	accrediting
accrud	accrued
accruin	accruing
accusd	accused
accusin	accusing
accustomd	accustomed
accustomin	accustoming
achievd	achieved
achievin	achieving
achin	aching
achvmnt	achievement
achvmnts	achievements
acidifyd	acidified
acidifying	acidifying
acknwldgmnt	acknowledgement
acquantd	acquainted
acquantin	acquainting
acrs	across
actd	acted
actin	acting
activ8	activate
activ8d	activated
activ8in	activating
actvty	activity
acut8d	actuated
acut8in	actuating
adaptd	adapted
adaptin	adapting
addr	address
adducd	adduced
adducin	adducing
adhrd	adhered
adhrin	adhering
adin	adding
adjoind	adjoined
adjoinin	adjoining
adjornd	adjourned
adjornin	adjourning
adjstd	adjusted
adjstin	adjusting
adjudc8d	adjudicated
adjudcatin	adjudicating
adlin	addling
adminstrd	administered
adminstrin	administering
admrd	admired
admrin	admiring
admttd	admitted
admttin	admitting
adoptd	adopted
adoptin	adopting
adord	adored
adorin	adoring
adornd	adorned
adornin	adorning
adrssd	addressed
adrssin	addressing
advancd	advanced
advancin	advancing
advisd	advised
advisin	advising
advoc8d	advocated
advoctin	advocating
advrtsd	advertised
advrtsin	advertising
afectin	affecting
affectd	affected
afiliatin	affiliating
afilit8d	affiliated
afirmd	affirmed
afirmin	affirming
afixd	affixed
afixin	affixing
aflictd	afflicted
aflictin	afflicting
aftr	after
agen	again
agin	ageing
agit8d	agitated
agitatin	agitating
agonisd	agonised
agonisin	agonising
agonizd	agonized
agonizin	agonizing
agrav8d	aggravated
agravatin	aggravating
agreein	agreeing
agreg8d	aggregated
agregatin	aggregating
agrid	agreed
aidin	aiding
ailin	ailing
aimd	aimed
aimin	aiming
aird	aired
airin	airing
airliftd	airlifted
airliftin	airlifting
aislin	aisling
aklimatised	acclimatised
aklimatisin	acclimatising
aklimatized	acclimatized
aklimatizin	acclimatizing
aknwldgd	acknowledged
aknwldgin	acknowledging
akordin	according
akostd	accosted
akostin	accosting
akumul8d	accumulated
akumulatin	accumulating
al	all
alarmd	alarmed
alertd	alerted
alghtin	alighting
alien8d	alienated
alienatin	alienating
alig8r	alligator
alightd	alighted
alignd	aligned
alignin	aligning
allayd	allayed
allayin	allaying
allegd	alleged
allegin	alleging
alloc8d	allocated
alloctin	allocating
allotd	allotted
allotin	allotting
allowd	allowed
alloyd	alloyed
allw	allow
allwed	allowed
allwing	allowing
almst	almost
alot	a lot
alowin	allowing
aloyin	alloying
alredi	already
alrmin	alarming
alrtin	alerting
alt	alternative
alterd	altered
alterin	altering
altern8d	alternated
alternatin	alternating
altho	although
aludin	alluding
alurin	alluring
alwz	always
alyin	allying
amazd	amazed
amazin	amazing
ambld	ambled
amblin	ambling
ambushd	ambushed
ambushin	ambushing
amendin	amending
amountd	amounted
amountin	amounting
amplfyin	amplifying
amput8d	amputated
amputatin	amputating
amusd	amused
amusin	amusing
amzng	amazing
anaesthetisd	anaesthetised
anaesthetisin	anaesthetising
analysd	analysed
analysin	analysing
anchord	anchored
anchorin	anchoring
angerd	angered
angerin	angering
anglin	angling
anim8d	animated
animatin	animating
anneald	annealed
annealin	annealing
annexd	annexed
annexin	annexing
annihil8d	annihilated
annihilatin	annihilating
annot8d	annotated
annotatin	annotating
annoyd	annoyed
anointin	anointing
anouncd	announced
anouncin	announcing
anoyin	annoying
answr	answer
answrd	answered
answrin	answering
antagonisd	antagonised
antagonisin	antagonising
antagonizd	antagonized
antagonizin	antagonizing
antedatin	antedating
anticp8d	anticipated
anticptin	anticipating
anulld	annulled
anullin	annulling
anytin	anything
anytin	anything
anywhr	anywhere
anywy	anyway
apalld	appalled
apallin	appalling
apeald	appealed
apealin	appealing
apeard	appeared
apearin	appearing
apeasd	appeased
apeasin	appeasing
apendin	appending
apertaind	appertained
apertainin	appertaining
apetisin	appetising
apetizin	appetizing
apin	aping
aplauded	applauded
aplaudin	applauding
aplyin	applying
apointd	appointed
apointin	appointing
apolgisd	apologised
apolgisin	apologising
apolgizd	apologized
apolgizin	apologizing
apolgs	apologise
apolgz	apologize
aportiond	apportioned
aportionin	apportioning
app	application
applyd	applied
apprci8	appreciate
apprntly	apparently
appropri8d	appropriated
appropriatin	appropriating
approxim8ly	approximately
apps	applications
apr	april
apraisd	appraised
apraisin	appraising
apreci8d	appreciated
apreciatin	appreciating
aprehended	apprehended
aprehendin	apprehending
aprised	apprised
aprisin	apprising
aproachd	approached
aproachin	approaching
aprovd	approved
aprovin	approving
aproxim8d	approximated
aproximatin	approximating
aquird	acquired
aquirin	acquiring
aquitd	acquitted
aquitin	acquitting
arbitr8d	arbitrated
arbitragin	arbitraging
arbitratin	arbitrating
archd	arched
archin	arching
archivin	archiving
arcin	arcing
arent	are not
argmnt	argument
argmnts	arguments
arguin	arguing
arising	arising
armd	armed
arming	arming
arnd	around
arosd	aroused
arosin	arousing
arrangd	arranged
arrangin	arranging
arrayd	arrayed
arrayin	arraying
arrestd	arrested
arrestin	arresting
arrivd	arrived
arrivin	arriving
articul8d	articulated
articulatin	articulating
asaild	assailed
asailin	assailing
asasin8d	assassinated
asasinatin	assassinating
asaultd	assaulted
asaultin	assaulting
ascendin	ascending
ascertaind	ascertained
ascertainin	ascertaining
ascribd	ascribed
ascribin	ascribing
asembld	assembled
asemblin	assembling
asentd	assented
asentin	assenting
asertd	asserted
asertin	asserting
asessd	assessed
asessin	assessing
asignd	assigned
asignin	assigning
asimil8d	assimilated
asimilatin	assimilating
asist	assist
asistd	assisted
asistin	assisting
askd	asked
askin	asking
asoci8d	associated
asociatin	associating
aspir8d	aspirated
aspiratin	aspirating
asstnt	assistant
assuagd	assuaged
assuagin	assuaging
assumd	assumed
assumin	assuming
assurd	assured
assurin	assuring
astonishd	astonished
astonishin	astonishing
astoundin	astounding
atachd	attached
atachin	attaching
atackd	attacked
atackin	attacking
ataind	attained
atainin	attaining
atemptd	attempted
atemptin	attempting
atended	attended
atendin	attending
atond	atoned
atonin	atoning
atrophyin	atrophying
attenu8d	attenuated
attenuatin	attenuating
attestd	attested
attestin	attesting
attn	attention
attractd	attracted
attractin	attracting
attributd	attributed
attributin	attributing
atx	adaptxt
auditd	audited
aug	august
authentic8d	authenticated
availd	availed
availin	availing
avengd	avenged
avengin	avenging
averagd	averaged
averagin	averaging
averrd	averred
averrin	averring
avertd	averted
avertin	averting
avlbl	available
avoidin	avoiding
avowd	avowed
avowin	avowing
aw8d	awaited
aw8in	awaiting
awakend	awakened
awakenin	awakening
awakin	awaking
awnin	awning
awrdin	awarding
axd	axed
axeler8d	accelerated
axeleratin	accelerating
axentd	accented
axentin	accenting
axentu8d	accentuated
axentuatin	accentuating
axeptd	accepted
axeptin	accepting
axesd	accessed
axesin	accessing
axesion	accession
axident	accident
axin	axing
b	be
b2	back to
b4	before
b8in	baiting
backd	backed
backin	backing
badgerd	badgered
baffld	baffled
bafflin	baffling
bagerin	badgering
baggd	bagged
baggin	bagging
baild	bailed
bailin	bailing
bak	back
bakbitin	backbiting
bakd	baked
bakfired	backfired
bakfirin	backfiring
bakground	background
bakin	baking
baklightin	backlighting
bakpackin	backpacking
bakslapin	backslapping
bakslidin	backsliding
baktraked	backtracked
baktrakin	backtracking
balancd	balanced
balancin	balancing
baldin	balding
balin	baling
balkin	balking
balloond	ballooned
balloonin	ballooning
ballotd	balloted
ballotin	balloting
bandagin	bandaging
bandin	banding
bandyin	bandying
bangd	banged
bangin	banging
banishd	banished
banishin	banishing
bankd	banked
bankin	banking
bankrolld	bankrolled
bankrollin	bankrolling
bankruptd	bankrupted
bankruptin	bankrupting
bannd	banned
bannin	banning
banquetin	banqueting
banterd	bantered
banterin	bantering
baptisd	baptised
baptisin	baptising
baptizd	baptized
baptizin	baptizing
bargaind	bargained
bargainin	bargaining
bargin	barging
barin	baring
barkd	barked
barkin	barking
barnstormd	barnstormed
barnstormin	barnstorming
barrackin	barracking
barrd	barred
barricadin	barricading
barrin	barring
barterd	bartered
barterin	bartering
bashd	bashed
bashin	bashing
basin	basing
baskin	basking
bastin	basting
bathd	bathed
bathin	bathing
battend	battened
battenin	battening
batterd	battered
batterin	battering
battin	batting
battlin	battling
baulkin	baulking
bawlin	bawling
bayin	baying
bb	be back
bbq	barbecue
bby	baby
bcame	became
bcum	become
bcums	becomes
bd	big deal
bday	birthday
bdy	body
beachd	beached
beachin	beaching
beadin	beading
beamd	beamed
beamin	beaming
bearin	bearing
beatin	beating
beckond	beckoned
beckonin	beckoning
becomin	becoming
beddin	bedding
beefd	beefed
beefin	beefing
beekeepin	beekeeping
beepin	beeping
beggd	begged
beggin	begging
bein	being
belchd	belched
belchin	belching
belin	belling
belittld	belittled
belittlin	belittling
belowin	bellowing
beltin	belting
belyin	belying
bemoanin	bemoaning
benchmarkin	benchmarking
bendin	bending
benefitd	benefited
benefitin	benefiting
bequeathd	bequeathed
bequeathin	bequeathing
ber8d	berated
beratin	berating
berin	bering
berthd	berthed
berthin	berthing
beseechd	beseeched
beseechin	beseeching
besettin	besetting
besiegd	besieged
besiegin	besieging
bespeakin	bespeaking
bestin	besting
bestirrd	bestirred
bestirrin	bestirring
bestowd	bestowed
bestowin	bestowing
betrayd	betrayed
betrayin	betraying
betterd	bettered
betterin	bettering
bettin	betting
bewaild	bewailed
bewailin	bewailing
bewldrd	bewildered
bewldrin	bewildering
bewtchd	bewitched
bewtchin	bewitching
bf	boyfriend
bfallin	befalling
bfittin	befitting
bfriendin	befriending
bg	big
bgettin	begetting
bginin	beginning
bguilin	beguiling
bhavin	behaving
bheadin	beheading
biasd	biased
biasin	biasing
bickerin	bickering
bicycld	bicycled
bicyclin	bicycling
biddin	bidding
bidin	biding
bikin	biking
biletin	billeting
bilkin	bilking
billd	billed
billin	billing
bilowd	billowed
bilowin	billowing
bindin	binding
birthin	birthing
bisectd	bisected
bisectin	bisecting
bitchin	bitching
bitin	biting
biz	business
bk	book
bl2th	bluetooth
blabberin	blabbering
blackballd	blackballed
blackballin	blackballing
blackd	blacked
blackend	blackened
blackenin	blackening
blackin	blacking
blacklistd	blacklisted
blacklistin	blacklisting
blakmaild	blackmailed
blakmailin	blackmailing
blamd	blamed
blamin	blaming
blanchd	blanched
blanchin	blanching
blankd	blanked
blanketd	blanketed
blanketin	blanketing
blankin	blanking
blard	blared
blaring	blaring
blasphemd	blasphemed
blasphemin	blaspheming
blastd	blasted
blastin	blasting
blazd	blazed
blazin	blazing
bleachd	bleached
bleachin	bleaching
bleatd	bleated
bleatin	bleating
bleedin	bleeding
bleepin	bleeping
blendin	blending
blessin	blessing
blggng	blogging
bliev	believe
blievd	believed
blievin	believing
blightin	blighting
blindin	blinding
blinkin	blinking
blisterin	blistering
bloatin	bloating
blockadin	blockading
blockbustin	blockbusting
blockin	blocking
blogin	blogging
blongd	belonged
blongin	belonging
bloodin	blooding
bloodlettin	bloodletting
bloomin	blooming
blosomin	blossoming
blottin	blotting
blowin	blowing
blubberin	blubbering
bludgeonin	bludgeoning
bluffin	bluffing
blunderin	blundering
bluntin	blunting
blurrin	blurring
blurtin	blurting
blushin	blushing
blusterin	blustering
blve	believe
bn	been
boardin	boarding
boastin	boasting
boatin	boating
bobbin	bobbing
bobsleddin	bobsledding
bodgin	bodging
bodin	boding
bodybuildin	bodybuilding
boggin	bogging
bogglin	boggling
boild	boiled
boilin	boiling
bolin	boling
bolsterin	bolstering
bolting	bolting
bombardin	bombarding
bombin	bombing
bondin	bonding
bonkin	bonking
booin	booing
bookbindin	bookbinding
bookin	booking
bookkeepin	bookkeeping
bookmakin	bookmaking
boomd	boomed
boomerangin	boomeranging
boomin	booming
boostd	boosted
boostin	boosting
bootin	booting
bootleggin	bootlegging
boozin	boozing
borderin	bordering
borin	boring
borrowin	borrowing
bossin	bossing
botchin	botching
botherd	bothered
botherin	bothering
bottld	bottled
bottlin	bottling
bottomin	bottoming
bouncin	bouncing
boundin	bounding
bowdlerisin	bowdlerising
bowin	bowing
bowlin	bowling
bowrin	bowring
boxin	boxing
boycottin	boycotting
bracin	bracing
bracketin	bracketing
bradin	brading
braggin	bragging
braidin	braiding
brainstormin	brainstorming
brainwashin	brainwashing
brakin	braking
branchin	branching
brandin	branding
brandishin	brandishing
bravin	braving
brawlin	brawling
brayin	braying
brb	be right back
breachin	breaching
breakfastin	breakfasting
breakin	breaking
breastfeedin	breastfeeding
breastin	breasting
breathd	breathed
breathin	breathing
breathtakin	breathtaking
breedin	breeding
breezin	breezing
brewin	brewing
bribin	bribing
brickin	bricking
bricklayin	bricklaying
bridgin	bridging
bridlin	bridling
briefd	briefed
briefin	briefing
brightend	brightened
brightenin	brightening
brimmin	brimming
brin	bring
bringin	bringing
bristlin	bristling
brite	bright
brk	break
bro	brother
broachin	broaching
broadcastin	broadcasting
broadend	broadened
broadenin	broadening
broilin	broiling
brokerin	brokering
brokin	broking
broodin	brooding
bros	brothers
browbeatin	browbeating
brownd	browned
brownin	browning
browsd	browsed
browsin	browsing
brrw	borrow
brstl	bristol
bruisd	bruised
bruisin	bruising
brushd	brushed
brushin	brushing
brutalisin	brutalising
brutalizin	brutalizing
brwsr	browser
bst	best
bstsellin	bestselling
bth	both
btr	better
bttnholin	buttonholing
bttnin	buttoning
btw	by the way
btwn	between
bubblin	bubbling
bucketin	bucketing
buckin	bucking
bucklin	buckling
buddin	budding
budgetin	budgeting
budgin	budging
buferin	buffering
bufetin	buffeting
bufin	buffing
buggerd	buggered
buggerin	buggering
buggin	bugging
buildin	building
buldozin	bulldozing
bulfightin	bullfighting
bulgin	bulging
bulkin	bulking
bullrin	bullring
bullyin	bullying
bumblin	bumbling
bumpd	bumped
bumpin	bumping
bunchd	bunched
bunchin	bunching
bundlin	bundling
bunglin	bungling
buntin	bunting
buoyin	buoying
burblin	burbling
burdenin	burdening
burgeonin	burgeoning
burgld	burgled
burglin	burgling
burnd	burned
burnin	burning
burnishd	burnished
burnishin	burnishing
burpd	burped
burpin	burping
burrowd	burrowed
burrowin	burrowing
burstin	bursting
buryin	burying
buskin	busking
bussin	bussing
bustd	busted
bustin	busting
bustld	bustled
bustlin	bustling
busyin	busying
butcherd	butchered
butcherin	butchering
butfl	beautiful
butterd	buttered
butterin	buttering
buttin	butting
buttond	buttoned
buttressin	buttressing
buyin	buying
buzzd	buzzed
buzzin	buzzing
bx	box
bypassd	bypassed
bypassin	bypassing
bzy	busy
c	see
c8rd	catered
c8rin	catering
cablin	cabling
cacklin	cackling
caddyin	caddying
cajolin	cajoling
calcul8	calculate
calculatin	calculating
calibratin	calibrating
callin	calling
calmin	calming
calvin	calving
camouflagin	camouflaging
campaignin	campaigning
campd	camped
campin	camping
canceld	cancelled
cancellin	cancelling
canin	caning
cannibalisin	cannibalising
cannin	canning
cannonin	cannoning
canoein	canoeing
cant	cannot
canterin	cantering
canvassin	canvassing
caperin	capering
capitalisin	capitalising
capitalizin	capitalizing
capitulatin	capitulating
cappin	capping
capsizin	capsizing
captainin	captaining
captionin	captioning
captivatin	captivating
capturd	captured
capturin	capturing
caravannin	caravanning
cardin	carding
careenin	careening
careerin	careering
caressin	caressing
carin	caring
carjackin	carjacking
carlin	carling
carousin	carousing
carpetin	carpeting
carpin	carping
carryin	carrying
cartin	carting
cartoonin	cartooning
carvin	carving
cascadin	cascading
cashd	cashed
cashin	cashing
casin	casing
castigatin	castigating
castin	casting
castratin	castrating
cataloguin	cataloguing
catalysin	catalysing
catapultin	catapulting
catchin	catching
categoris	categories
categorisd	categorised
categorisin	categorising
categorizd	categorized
categorizin	categorizing
categry	category
caulkin	caulking
cauterisin	cauterising
cauterizin	cauterizing
cautionin	cautioning
cavin	caving
cavortin	cavorting
cawing	cawing
cc	carbon copy
ceasd	ceased
ceasin	ceasing
cedin	ceding
ceilin	ceiling
celebratin	celebrating
cementin	cementing
censorin	censoring
censurin	censuring
centralisin	centralising
centralizin	centralizing
centrd	centred
centrin	centring
certifyin	certifying
cffee	coffee
chafd	chafed
chaffd	chaffed
chaffin	chaffing
chafin	chafing
chaind	chained
chainin	chaining
chaird	chaired
chairin	chairing
chalkd	chalked
chalkin	chalking
challengin	challenging
champin	champing
championd	championed
championin	championing
champship	championship
chancd	chanced
chancin	chancing
changd	changed
changelin	changeling
changin	changing
channeld	channelled
channellin	channelling
channin	channing
chantin	chanting
chappin	chapping
characterisd	characterised
characterisin	characterising
characterizd	characterized
characterizin	characterizing
chargd	charged
chargin	charging
charin	charing
charmd	charmed
charmin	charming
charrin	charring
charterin	chartering
chartin	charting
chasd	chased
chasin	chasing
chastenin	chastening
chastisin	chastising
chattd	chatted
chatterin	chattering
chattin	chatting
chck	check
cheapend	cheapened
cheapenin	cheapening
cheatd	cheated
cheatin	cheating
checkd	checked
checkin	checking
cheerin	cheering
cherishin	cherishing
chewin	chewing
chidin	chiding
childbearin	childbearing
chilld	chilled
chillin	chilling
chimin	chiming
chinkin	chinking
chippin	chipping
chirpin	chirping
chirrupin	chirruping
chisellin	chiselling
chivvyin	chivvying
chk	check
chloro4min	chloroforming
chmstry	chemistry
chnce	chance
chng	change
chng	change
chngd	changed
chngin	changing
chngs	changes
chokin	choking
chompin	chomping
chongqin	chongqing
choosin	choosing
choppd	chopped
choppin	chopping
choreografin	choreographing
chortlin	chortling
chrctr	character
christenin	christening
chroniclin	chronicling
chuckd	chucked
chuckin	chucking
chuckld	chuckled
chucklin	chuckling
chuggin	chugging
chunderin	chundering
chunterin	chuntering
churchgoin	churchgoing
churnin	churning
circld	circled
circlin	circling
circulatin	circulating
circumscribin	circumscribing
circumventin	circumventing
citin	citing
civilisin	civilising
civilizin	civilizing
civlisd	civilised
civlizd	civilized
clackin	clacking
claddin	cladding
claimin	claiming
clamberin	clambering
clammin	clamming
clamourin	clamouring
clampin	clamping
clangin	clanging
clankin	clanking
clappin	clapping
clarifyin	clarifying
clashd	clashed
clashin	clashing
claspd	clasped
claspin	clasping
classd	classed
classifyin	classifying
classin	classing
clatterd	clattered
clatterin	clattering
clawin	clawing
clb	club
clbr8	collaborate
clb's	club's
cld	cold
cleand	cleaned
cleanin	cleaning
cleansd	cleansed
cleansin	cleansing
cleard	cleared
clearin	clearing
cleavin	cleaving
clenchin	clenching
clickd	clicked
clickin	clicking
clik	click
climaxd	climaxed
climaxin	climaxing
climbd	climbed
climbin	climbing
clinchd	clinched
clinchin	clinching
clingin	clinging
clinkd	clinked
clinkin	clinking
clippin	clipping
cll	call
clld	called
cllin	calling
cloakin	cloaking
clockin	clocking
cloggd	clogged
cloggin	clogging
clond	cloned
clonin	cloning
clos	close
closd	closed
closd	closed
closin	closing
clothd	clothed
clothin	clothing
clottin	clotting
cloudin	clouding
clownin	clowning
cloyin	cloying
clss	class
clubbin	clubbing
cluckin	clucking
clumpin	clumping
clusterin	clustering
clutchin	clutching
clutterin	cluttering
cmon	come on
c'mon	come on
cmpnies	companies
cmpny	company
cmptr	computer
cn	can
cnnxion	connection
cnsdr	consider
cnsqntly	consequently
cnt	can't
cntinue	continue
cntxt	context
coachd	coached
coachin	coaching
coalescin	coalescing
coastin	coasting
coatin	coating
coaxin	coaxing
cobblin	cobbling
cockfightin	cockfighting
cockin	cocking
coddlin	coddling
codifyin	codifying
codin	coding
coercin	coercing
coexistin	coexisting
cogitatin	cogitating
cohabiti	cohabiting
coilin	coiling
coincidin	coinciding
coinin	coining
cokin	coking
collaboratin	collaborating
collapsd	collapsed
collapsin	collapsing
collarin	collaring
collatin	collating
collectin	collecting
collexion	collection
collidin	colliding
colluding	colluding
colonising	colonising
colonizd	colonized
colonizin	colonizing
colourd	coloured
colourin	colouring
com4t	comfort
com4tble	comfortable
com4tin	comforting
comandin	commanding
combatin	combating
combd	combed
combin	combing
combind	combined
combinin	combining
combnd	combined
comemoratin	commemorating
comencin	commencing
comendin	commending
comentatin	commentating
comentin	commenting
comin	coming
cominglin	commingling
comiseratin	commiserating
comissiond	commissioned
comissionin	commissioning
comitin	committing
commandeerin	commandeering
commentd	commented
compactin	compacting
compard	compared
comparin	comparing
compartmentalisin	compartmentalising
compeld	compelled
compellin	compelling
compensatin	compensating
competin	competing
compild	compiled
compilin	compiling
complaind	complained
complainin	complaining
complementd	complemented
complementin	complementing
completd	completed
completin	completing
complicatin	complicating
complimentin	complimenting
complyin	complying
composd	composed
composin	composing
compostin	composting
compoundin	compounding
comprehendin	comprehending
compresd	compressed
compresin	compressing
comprisd	comprised
comprisin	comprising
compromisd	compromised
compromisin	compromising
computerisin	computerising
computerizin	computerizing
computin	computing
comunicatin	communicating
comunin	communing
comutin	commuting
con4md	conformed
con4min	conforming
conceald	concealed
concealin	concealing
concedin	conceding
conceivd	conceived
conceivin	conceiving
concentratin	concentrating
conceptualisin	conceptualising
conceptualizin	conceptualizing
concernd	concerned
concernin	concerning
conciliatin	conciliating
concludin	concluding
concoctin	concocting
concretin	concreting
concrnd	concerned
concrnin	concerning
concurrin	concurring
condemnd	condemned
condemnin	condemning
condensd	condensed
condensin	condensing
condescendin	condescending
conditiond	conditioned
conditionin	conditioning
condond	condoned
condonin	condoning
conductd	conducted
conductin	conducting
conferencin	conferencing
conferrd	conferred
conferrin	conferring
confessd	confessed
confessin	confessing
confidin	confiding
configurd	configured
configurin	configuring
confind	confined
confinin	confining
confirmd	confirmed
confirmin	confirming
confiscatin	confiscating
conflatin	conflating
conflictin	conflicting
confoundin	confounding
confrontd	confronted
confrontin	confronting
confusd	confused
confusin	confusing
congealin	congealing
congrats	congratulations
congratulatin	congratulating
congregatin	congregating
conjecturin	conjecturing
conjoinin	conjoining
conjugatin	conjugating
conjurin	conjuring
connectd	connected
connectin	connecting
connivin	conniving
connotin	connoting
conquerin	conquering
conscriptin	conscripting
consecratin	consecrating
consentd	consented
consentin	consenting
conservd	conserved
conservin	conserving
considerd	considered
considerin	considering
consignd	consigned
consignin	consigning
consistd	consisted
consistin	consisting
consolidatin	consolidating
consolin	consoling
consortin	consorting
conspirin	conspiring
constitutd	constituted
constitutin	constituting
constraind	constrained
constrainin	constraining
constrictd	constricted
constrictin	constricting
constructd	constructed
constructin	constructing
construin	construing
consultd	consulted
consultin	consulting
consumd	consumed
consumin	consuming
contactd	contacted
contactin	contacting
containd	contained
containin	containing
contaminatin	contaminating
contct	contact
contcts	contacts
contemplatin	contemplating
contendin	contending
contentin	contenting
contestd	contested
contestin	contesting
continu	continue
continud	continued
continuin	continuing
contortin	contorting
contractin	contracting
contradictin	contradicting
contrastin	contrasting
contravenin	contravening
contributd	contributed
contributin	contributing
contrivin	contriving
controllin	controlling
convalescin	convalescing
convenin	convening
convergin	converging
conversin	conversing
convertin	converting
conveyancin	conveyancing
conveyin	conveying
convictin	convicting
convincin	convincing
convulsin	convulsing
cooin	cooing
cookd	cooked
cookin	cooking
coold	cooled
coolin	cooling
cooperatin	cooperating
coordinatin	coordinating
copin	coping
coppicin	coppicing
copulatin	copulating
copyin	copying
copyrightin	copyrighting
copyrite	copyright
cornerin	cornering
cornin	corning
corrallin	corralling
correctin	correcting
correlatin	correlating
correspondin	corresponding
corroboratin	corroborating
corrodin	corroding
corruptin	corrupting
cors	course
coruscatin	coruscating
cos	because
cosd	caused
cosin	causing
costin	costing
costumd	costumed
costumin	costuming
couchd	couched
couchin	couching
coughd	coughed
coughin	coughing
counsellin	counselling
countd	counted
countenancin	countenancing
counteractin	counteracting
counter-attackin	counter-attacking
counterbalancin	counterbalancing
counterfeitin	counterfeiting
counterin	countering
countervailin	countervailing
countin	counting
coupld	coupled
couplin	coupling
coursin	coursing
courtin	courting
coverd	covered
coverin	covering
covetin	coveting
cowerin	cowering
cowin	cowing
cowlin	cowling
coxin	coxing
cpture	capture
cquensd	sequenced
cr8	create
cr8ed	created
crackin	cracking
cracklin	crackling
cradlin	cradling
craftin	crafting
cramd	crammed
cramin	cramming
crampd	cramped
crampin	cramping
cranin	craning
crankd	cranked
crankin	cranking
crashd	crashed
crashin	crashing
cravd	craved
cravin	craving
crawld	crawled
crawlin	crawling
crcdl	crocodile
cre8d	created
cre8iv	creative
creakd	creaked
creakin	creaking
creamd	creamed
creamin	creaming
creasd	creased
creasin	creasing
creatin	creating
credentialin	credentialing
creditin	crediting
creepin	creeping
creosotin	creosoting
crestin	cresting
crewin	crewing
cribbin	cribbing
cricketin	cricketing
criminalisin	criminalising
crimpin	crimping
crinin	cringing
crinklin	crinkling
crippld	crippled
cripplin	crippling
crisscrossin	crisscrossing
criticisd	criticised
criticisin	criticising
croakin	croaking
croftin	crofting
crookin	crooking
croonin	crooning
croppin	cropping
crossexaminin	cross-examining
crossin	crossing
crosslinkin	cross-linking
crouchin	crouching
crowdin	crowding
crowin	crowing
crownin	crowning
crry	carry
crryd	carried
crucifyin	crucifying
cruisin	cruising
crumblin	crumbling
crumplin	crumpling
crunchin	crunching
crusadin	crusading
crushd	crushed
crushin	crushing
cryin	crying
crystallisin	crystallising
crystallizin	crystallizing
crzy	crazy
c-t	city
ctrl	control
cu	see you
cubin	cubing
cud	could
cuddlin	cuddling
cudnt	could not
cuein	cueing
cullin	culling
culminatin	culminating
cultivatin	cultivating
culturin	culturing
cummin	cumming
cunnin	cunning
cupl	couple
cuppin	cupping
curbin	curbing
curdlin	curdling
curin	curing
curlin	curling
curryin	currying
cursd	cursed
cursin	cursing
curtailin	curtailing
curtainin	curtaining
curtseyin	curtseying
curtsyin	curtsying
curvd	curved
curvin	curving
cushin	cushing
cushiond	cushioned
cushionin	cushioning
cussin	cussing
customisd	customised
customisin	customising
customizd	customized
customizin	customizing
cuttin	cutting
cya	see ya
cyclin	cycling
cynd	signed
cynpostd	signposted
czd	seized
czin	season
d	the
d4med	deformed
d4min	deforming
d8	date
d8ing	dating
dabbd	dabbed
dabbin	dabbing
dabblin	dabbling
dairyin	dairying
dallyin	dallying
damagd	damaged
damagin	damaging
dammd	dammed
dammin	damming
damnd	damned
damnin	damning
dampd	damped
dampend	dampened
dampenin	dampening
dampin	damping
dancd	danced
dancin	dancing
dangld	dangled
danglin	dangling
darin	daring
darjeelin	darjeeling
darkend	darkened
darkenin	darkening
darlin	darling
darnin	darning
dartin	darting
dashin	dashing
dat	that
datin	dating
daubd	daubed
daubin	daubing
dauntin	daunting
dawdlin	dawdling
dawnd	dawned
dawnin	dawning
daydreamin	daydreaming
dazzld	dazzled
dazzlin	dazzling
db8	debate
dcayin	decaying
dceivd	deceived
dceivin	deceiving
dceler8d	decelerated
dceleratin	decelerating
dcentralised	decentralised
dcentralisin	decentralising
dcentralized	decentralized
dcentralizin	decentralizing
dcide	decide
dcided	decided
dcided	decided
dcidin	deciding
dcim8d	decimated
dcimatin	decimating
dcifered	deciphered
dciferin	deciphering
dcked	decked
dckin	decking
dclaimed	declaimed
dclaimin	declaiming
dclared	declared
dclarin	declaring
dclined	declined
dclinin	declining
dcoded	decoded
dcomissioned	decommissioned
dcomissionin	decommissioning
dcompressed	decompressed
dcompressin	decompressing
dconstructed	deconstructed
dconstructin	deconstructing
dcontamin8d	decontaminated
dcontaminatin	decontaminating
dcontrolled	decontrolled
dcontrollin	decontrolling
dcor8ed	decorated
dcoratin	decorating
dcoupld	decoupled
dcouplin	decoupling
dcoyin	decoying
dcreasd	decreased
dcreasin	decreasing
dcreein	decreeing
dcriminalisd	decriminalised
dcriminalisin	decriminalising
dcryin	decrying
dcsion	decision
dcsions	decisions
deactiv8d	deactivated
deactivatin	deactivating
deadenin	deadening
deafenin	deafening
dealin	dealing
debasd	debased
debasin	debasing
debatin	debating
debilitatin	debilitating
debitin	debiting
debriefin	debriefing
debuggd	debugged
debuggin	debugging
debunkd	debunked
debunkin	debunking
debutin	debuting
dec	december
decantin	decanting
decapitatin	decapitating
decodin	decoding
decomposed	decomposed
decomposin	decomposing
dedicatin	dedicating
deducd	deduced
deducin	deducing
deductd	deducted
deductin	deducting
deemd	deemed
deemin	deeming
deepend	deepened
deepenin	deepening
deepin	deeping
def	definitely
defacin	defacing
defamin	defaming
defaultin	defaulting
deicin	deicing
deifyin	deifying
deignin	deigning
delayd	delayed
delayin	delaying
deleg8d	delegated
delegatin	delegating
deliberatin	deliberating
delite	delight
delited	delighted
deliverd	delivered
deliverin	delivering
deludin	deluding
delugin	deluging
delvin	delving
demandin	demanding
demarcatin	demarcating
demo	demonstration
democratisin	democratising
demoing	demonstrating
demolishd	demolished
demolishin	demolishing
demonstr8d	demonstrated
demonstratin	demonstrating
demoralisd	demoralised
demoralisin	demoralising
demoralizd	demoralized
demoralizin	demoralizing
demos	demonstrations
demotin	demoting
demurrin	demurring
demystifyin	demystifying
denigratin	denigrating
dennin	denning
denotin	denoting
denouncin	denouncing
dentin	denting
denyin	denying
depersonalisin	depersonalising
depictd	depicted
depictin	depicting
depletd	depleted
depletin	depleting
deplord	deplored
deplorin	deploring
deployd	deployed
deployin	deploying
deportin	deporting
deposin	deposing
depositin	depositing
depravin	depraving
deprecatin	deprecating
depreciatin	depreciating
depressin	depressing
deprivin	depriving
deprssd	depressed
deprssn	depression
dept	department
depts	departments
deputisin	deputising
deputizin	deputizing
derailin	derailing
deregulatin	deregulating
deridin	deriding
derivin	deriving
descendin	descending
describin	describing
descrptn	description
desecratin	desecrating
desegregatin	desegregating
desensitisin	desensitising
desertin	deserting
deservd	deserved
deservin	deserving
design8d	designated
designatin	designating
designd	designed
designin	designing
desird	desired
desirin	desiring
desistd	desisted
desistin	desisting
deskillin	deskilling
desolatin	desolating
despairin	despairing
despatchin	despatching
despisin	despising
despoilin	despoiling
destabilisin	destabilising
destabilizin	destabilizing
destroyd	destroyed
destroyin	destroying
detachd	detached
detachin	detaching
detaild	detailed
detailin	detailing
detaind	detained
detainin	detaining
detectin	detecting
deterioratin	deteriorating
determinin	determining
deterrin	deterring
detonatin	detonating
detoxifyin	detoxifying
detractin	detracting
devaluin	devaluing
devastatin	devastating
deviatin	deviating
devisin	devising
devlopin	developing
devlp	develop
devlpd	developed
devlpr	developer
devlprs	developers
devolvin	devolving
devotin	devoting
devourin	devouring
dey	they
dfeatd	defeated
dfeatin	defeating
dfecatin	defecating
dfectin	defecting
dfendin	defending
dferrin	deferring
dffrnce	difference
dffrnces	differences
dfilin	defiling
dfined	defined
dfinin	defining
dfl8d	deflated
dflating	deflating
dflected	deflected
dflectin	deflecting
dflowerin	deflowering
dfraudin	defrauding
dfrostin	defrosting
dfusin	defusing
dfyin	defying
dgener8d	degenerated
dgeneratin	degenerating
dgraded	degraded
dgradin	degrading
dgtl	digital
dh	dear hubby
dhumanisin	dehumanising
dhumanizin	dehumanizing
dhydratin	dehydrating
di	die
diagnosin	diagnosing
diallin	dialling
dicin	dicing
dict8	dictate
dictatin	dictating
didnt	did not
didnt	did not
dietin	dieting
diferent	different
differentiatin	differentiating
differin	differing
diffractin	diffracting
diffusin	diffusing
digestin	digesting
diggin	digging
digitisin	digitising
digitizin	digitizing
dignifyin	dignifying
digressin	digressing
dilatin	dilating
dilutin	diluting
diminishin	diminishing
dimmin	dimming
dinin	dining
dinr	dinner
dippin	dipping
dir	directory
directin	directing
dirtyin	dirtying
disablin	disabling
disagreein	disagreeing
disappeard	disappeared
disappearin	disappearing
disappointd	disappointed
disappointin	disappointing
disapprovd	disapproved
disapprovin	disapproving
disarmd	disarmed
disarmin	disarming
disarrangin	disarranging
disassembld	disassembled
disassemblin	disassembling
disassoci8d	disassociated
disassociatin	disassociating
disavowin	disavowing
disbandin	disbanding
disbelievin	disbelieving
disbursin	disbursing
discardin	discarding
discernin	discerning
dischargin	discharging
disciplinin	disciplining
disclaimin	disclaiming
disclosin	disclosing
disconcertin	disconcerting
disconnectin	disconnecting
discontinuin	discontinuing
discountin	discounting
discouragin	discouraging
discoursin	discoursing
discoverin	discovering
discrditin	discrediting
discriminatin	discriminating
discus	discuss
discusd	discussed
discusin	discussing
disdainin	disdaining
disembarkin	disembarking
disenfranchisin	disenfranchising
disengagin	disengaging
disentanglin	disentangling
disestablishin	disestablishing
disfigurin	disfiguring
disgorgin	disgorging
disgracin	disgracing
disguisin	disguising
disgustin	disgusting
disheartenin	disheartening
dishin	dishing
disillusionin	disillusioning
disinfectin	disinfecting
disintegratin	disintegrating
dislikin	disliking
dislocatin	dislocating
dislodgin	dislodging
dismantlin	dismantling
dismayin	dismaying
dismemberin	dismembering
dismissin	dismissing
dismountin	dismounting
disobeyin	disobeying
disorientatin	disorientating
disorientin	disorienting
disownin	disowning
disparagin	disparaging
dispatchin	dispatching
dispellin	dispelling
dispensin	dispensing
dispersin	dispersing
dispiritin	dispiriting
displacin	displacing
displayin	displaying
displeasin	displeasing
disportin	disporting
disposin	disposing
disprovin	disproving
disputin	disputing
disqualifyin	disqualifying
disquietin	disquieting
disregardin	disregarding
disrobin	disrobing
disruptin	disrupting
dissectin	dissecting
dissemblin	dissembling
disseminatin	disseminating
dissentin	dissenting
dissipatin	dissipating
dissociatin	dissociating
dissolvd	dissolved
dissolvin	dissolving
distancin	distancing
distillin	distilling
distinuishin	distinguishing
distortin	distorting
distractin	distracting
distresin	distressing
distributin	distributing
distrustin	distrusting
disturbd	disturbed
disturbin	disturbing
disuadin	dissuading
ditchd	ditched
ditchin	ditching
ditherin	dithering
divergin	diverging
diversifyin	diversifying
divertin	diverting
divestin	divesting
dividin	dividing
divin	diving
divinin	divining
divorcd	divorced
divorcin	divorcing
divsn	division
divsns	divisions
divulgin	divulging
diy	do it yourself
dizzyin	dizzying
dk	don't know
dl	download
dlight	delight
dlightin	delighting
dlimitin	delimiting
dlineatin	delineating
dltin	deleting
dmand	demand
dmeanin	demeaning
dmn	damn
dnd	do not disturb
dngerous	dangerous
doc	document
dockin	docking
docs	documents
doctorin	doctoring
documentin	documenting
dodderin	doddering
dodgin	dodging
doffin	doffing
doggin	dogging
doin	doing
dominatin	dominating
domineerin	domineering
donatin	donating
donnin	donning
dont	do not
dont	don't
doodlin	doodling
doomin	dooming
dopin	doping
dorkin	dorking
dosin	dosing
dotin	doting
dottin	dotting
doublin	doubling
doubtin	doubting
douchin	douching
dousin	dousing
dowlin	dowling
downgradin	downgrading
downin	downing
downloadin	downloading
downplayin	downplaying
downsizin	downsizing
downswin	downswing
dowsin	dowsing
dozin	dozing
dpartd	departed
dpartin	departing
dpendin	depending
dpersonalizin	depersonalizing
draftin	drafting
draggin	dragging
drainin	draining
dramatisin	dramatising
drapin	draping
drawin	drawing
drawlin	drawling
drctr	director
dreadin	dreading
dreamin	dreaming
dredgin	dredging
drenchin	drenching
dressin	dressing
dressmakin	dressmaking
dribblin	dribbling
driftin	drifting
drillin	drilling
drinkin	drinking
drippin	dripping
drivellin	drivelling
drivin	driving
drizzlin	drizzling
dronin	droning
droolin	drooling
droopin	drooping
droppin	dropping
drownin	drowning
drubbin	drubbing
druggin	drugging
drumin	drumming
dryin	drying
dsallowd	disallowed
dsallowin	disallowing
dscrption	description
dscssn	discussion
dspite	despite
dtrmind	determined
dubbin	dubbing
duckin	ducking
ducklin	duckling
ductin	ducting
duellin	duelling
dullin	dulling
dumbfoundin	dumbfounding
dumpin	dumping
dumplin	dumpling
dun	done
dunkin	dunking
dunnin	dunning
dupin	duping
duplicatin	duplicating
durin	during
dustin	dusting
duz	does
dv8	deviate
dvice	device
dvlpmnt	development
dwarfin	dwarfing
dwellin	dwelling
dwindlin	dwindling
dwn	down
dwntwn	downtown
dy	day
dyein	dyeing
dyin	dying
ealin	ealing
earmarkd	earmarked
earmarkin	earmarking
earnd	earned
earnin	earning
earrin	earring
earthlin	earthling
easd	eased
easin	easing
eastrn	eastern
easygoin	easygoing
eatin	eating
eavesdroppd	eavesdropped
eavesdroppin	eavesdropping
ebbd	ebbed
ebbin	ebbing
echod	echoed
echoin	echoing
eclipsd	eclipsed
eclipsin	eclipsing
economisd	economised
economisin	economising
economizd	economized
economizin	economizing
eddyin	eddying
edgin	edging
edifyin	edifying
editin	editing
ednbrgh	edinburgh
edu	education
educ8	educate
educ8d	educated
educatin	educating
effacin	effacing
effectin	effecting
effin	effing
eft	electronic funds transfer
eg	for example
eggin	egging
ejacul8d	ejaculated
ejaculatin	ejaculating
ejectd	ejected
ejectin	ejecting
ekin	eking
elabor8	elaborate
elabor8d	elaborated
elabor8in	elaborating
elapsd	elapsed
elapsin	elapsing
elbowd	elbowed
elbowin	elbowing
electd	elected
electin	electing
electioneerin	electioneering
electrifyin	electrifying
electrocutd	electrocuted
electrocutin	electrocuting
electroplatin	electroplating
elev8d	elevated
elevatin	elevating
elicitd	elicited
elicitin	eliciting
elidin	eliding
elimin8	eliminate
elimin8d	eliminated
elimin8in	eliminating
elong8d	elongated
elongatin	elongating
elopd	eloped
elopin	eloping
els	else
elucid8d	elucidated
elucidatin	elucidating
eludin	eluding
email	e-mail
emailin	e-mailing
eman8	emanate
eman8d	emanated
emanatin	emanating
emancip8d	emancipated
emancipatin	emancipating
emascul8d	emasculated
emasculatin	emasculating
embalmd	embalmed
embalmin	embalming
embarkd	embarked
embarkin	embarking
embarrasd	embarrassed
embarrassin	embarrassing
embeddin	embedding
embellishd	embellished
embellishin	embellishing
embezzld	embezzled
embezzlin	embezzling
embitterd	embittered
embitterin	embittering
embodyin	embodying
emboldend	emboldened
emboldenin	emboldening
embossd	embossed
embossin	embossing
embracd	embraced
embracin	embracing
embroiderd	embroidered
embroiderin	embroidering
embroild	embroiled
embroilin	embroiling
emergd	emerged
emergin	emerging
emigr8d	emigrated
emigratin	emigrating
emittd	emitted
emittin	emitting
empathisin	empathising
emfasisd	emphasised
emfasisin	emphasising
emfasizd	emphasized
emfasizin	emphasizing
employd	employed
employin	employing
empowerd	empowered
empowerin	empowering
emptyd	emptied
emptyin	emptying
emul8d	emulated
emulatin	emulating
en4cin	enforcing
enabld	enabled
enablin	enabling
enactd	enacted
enactin	enacting
encapsul8d	encapsulated
encapsulatin	encapsulating
encasd	encased
encasin	encasing
enchantd	enchanted
enchantin	enchanting
encirclin	encircling
enclosin	enclosing
encodin	encoding
encompassin	encompassing
encounterin	encountering
encouragin	encouraging
encroachin	encroaching
encryptin	encrypting
encumberin	encumbering
endangerin	endangering
endearin	endearing
endeavourin	endeavouring
endin	ending
endorsin	endorsing
endowin	endowing
endurin	enduring
energisin	energising
enervatin	enervating
enfranchisin	enfranchising
eng	english
engagin	engaging
engenderin	engendering
engineerin	engineering
engnrng	engineering
engravin	engraving
engrossin	engrossing
engulfin	engulfing
enhancin	enhancing
enjoinin	enjoining
enjoyin	enjoying
enlargin	enlarging
enlightenin	enlightening
enlistin	enlisting
enlivend	enlivened
enlivenin	enlivening
ennobld	ennobled
ennoblin	ennobling
enquird	enquired
enquirin	enquiring
enragd	enraged
enragin	enraging
enrichd	enriched
enrichin	enriching
enrolld	enrolled
enrollin	enrolling
enshrinin	enshrining
enslavd	enslaved
enslavin	enslaving
ensnard	ensnared
ensnarin	ensnaring
ensuin	ensuing
ensurd	ensured
ensurin	ensuring
entaild	entailed
entailin	entailing
entangld	entangled
entanglin	entangling
enterd	entered
enterin	entering
enterprisin	enterprising
entertaind	entertained
entertainin	entertaining
enthrallin	enthralling
enthusin	enthusing
enticin	enticing
entitlin	entitling
entrappin	entrapping
entreatin	entreating
entrenchin	entrenching
entrustin	entrusting
entwinin	entwining
enuf	enough
enumeratin	enumerating
enunciatin	enunciating
envelopin	enveloping
envisagin	envisaging
envrnment	environment
envyin	envying
eppin	epping
equalisin	equalising
equalizin	equalizing
equallin	equalling
equatin	equating
equippin	equipping
equivocatin	equivocating
eradicatin	eradicating
erasin	erasing
erectin	erecting
erlier	earlier
erly	early
erodin	eroding
errin	erring
eruptin	erupting
escalatin	escalating
escapd	escaped
escapin	escaping
eschewin	eschewing
escortin	escorting
espcially	especially
espousin	espousing
espyin	espying
establishin	establishing
estimatin	estimating
etchin	etching
eu	european union
eulogisin	eulogising
eulogizin	eulogizing
eurp	europe
evacuatin	evacuating
evadin	evading
evaluatin	evaluating
evangelizin	evangelizing
evaporatin	evaporating
evend	evened
evenin	evening
eventin	eventing
everchangin	ever-changing
everlastin	everlasting
everythin	everything
evictd	evicted
evictin	evicting
evn	even
evokd	evoked
evokin	evoking
evolvd	evolved
evolvin	evolving
evr	ever
evry	every
evry1	everyone
evrybdy	everybody
evrytin	everything
ewin	ewing
exam	examination
excusd	excused
exec	executive
exprmnt	experiment
exprmnts	experiments
eyein	eyeing
ezy	easy
f2f	face to face
f2t	free to talk
fabric8d	fabricated
fabricatin	fabricating
fabrik8d	fabricated
facilit8d	facilitated
facilit8d	facilitated
facilitatin	facilitating
facin	facing
factord	factored
factord	factored
factorin	factoring
factorisd	factorised
factorisd	factorised
factorisin	factorising
factorizd	factorized
factorizd	factorized
factorizin	factorizing
fadin	fading
faild	failed
failin	failing
faintd	fainted
faintd	fainted
faintin	fainting
fakin	faking
fallin	falling
falsifyin	falsifying
falterd	faltered
falterd	faltered
falterin	faltering
familiarisd	familiarised
familiarisd	familiarised
familiarisin	familiarising
fancyin	fancying
fand	fanned
fannd	fanned
fannin	fanning
fantasisd	fantasised
fantasisd	fantasised
fantasisin	fantasising
fantasizd	fantasized
fantasizd	fantasized
fantasizin	fantasizing
faq	frequently asked questions
farin	faring
farmd	farmed
farmd	farmed
farmin	farming
farthin	farthing
fascin8d	fascinated
fascinatin	fascinating
fashiond	fashioned
fashionin	fashioning
fasin	phasing
fasin8d	fascinated
fastd	fasted
fastend	fastened
fastenin	fastening
fastin	fasting
fastnd	fastened
fatherd	fathered
fatherin	fathering
fathomd	fathomed
fathomd	fathomed
fathomin	fathoming
fathrd	fathered
fatigd	fatigued
fatiguin	fatiguing
fatnd	fattened
fattend	fattened
fattenin	fattening
faultd	faulted
faultin	faulting
fave	favourite
favord	favoured
favourin	favouring
fawnd	fawned
fawnin	fawning
faxd	faxed
faxin	faxing
fbm	fine by me
fcbk	facebook
fctr	factor
fctrs	factors
feard	feared
fearin	fearing
feastd	feasted
feastin	feasting
feated	featured
featherbeddin	featherbedding
featherd	feathered
featherin	feathering
featurin	featuring
feb	february
feedin	feeding
feelin	feeling
feeln	feeling
feignin	feigning
feintin	feinting
fellin	felling
fencin	fencing
fendin	fending
feretd	ferreted
fermentin	fermenting
ferretin	ferreting
ferryin	ferrying
fertilisd	fertilised
fertilisin	fertilising
fertilizd	fertilized
fertilizin	fertilizing
feryd	ferried
festerd	festered
festerin	festering
festoonin	festooning
fetchd	fetched
fetchin	fetching
feuded	feuded
feudin	feuding
fghtin	fighting
fibbin	fibbing
fiddlin	fiddling
fidgetd	fidgeted
fidgetin	fidgeting
fidld	fiddled
fieldin	fielding
figurin	figuring
filanderin	philandering
fild	filled
filin	filing
filld	filled
filld	filled
fillin	filling
filmd	filmed
filmd	filmed
filmin	filming
filmmakin	filmmaking
filosofisin	philosophising
filosofizin	philosophizing
filterd	filtered
filterin	filtering
finalisd	finalised
finalisin	finalising
finalizd	finalized
finalizin	finalizing
financd	financed
financin	financing
findin	finding
fingerin	fingering
fingerprinting	fingerprinting
fining	fining
finishin	finishing
finishing	finishing
finshd	finished
firebombing	firebombing
firing	firing
firmd	firmed
firming	firming
fishing	fishing
fitd	fitted
fitting	fitting
fixd	fixed
fixing	fixing
fizd	fizzed
fizld	fizzled
fizzing	fizzing
fizzling	fizzling
flagd	flagged
flagging	flagging
flaild	flailed
flailing	flailing
flakd	flaked
flaking	flaking
flaming	flaming
flankd	flanked
flankd	flanked
flanking	flanking
flapd	flapped
flappd	flapped
flapping	flapping
flared	flared
flaring	flaring
flashd	flashed
flashing	flashing
flatend	flattened
flaterd	flattered
flattening	flattening
flattering	flattering
flauntd	flaunted
flaunting	flaunting
flavourd	flavoured
flavouring	flavouring
flayd	flayed
flaying	flaying
fledgling	fledgling
fleecing	fleecing
fleeing	fleeing
fleeting	fleeting
fleming	fleming
fleshd	fleshed
fleshing	fleshing
flexd	flexed
flexing	flexing
flickd	flicked
flickering	flickering
flicking	flicking
flikd	flicked
flikrd	flickered
flinchd	flinched
flinching	flinching
fling	fling
flinging	flinging
flipd	flipped
flipping	flipping
flirting	flirting
flitd	flitted
flitting	flitting
fllw	follow
fllwin	following
fllwn	following
fllwrs	followers
floating	floating
flockd	flocked
flocking	flocking
flogd	flogged
floggd	flogged
flogging	flogging
flokd	flocked
flooding	flooding
floodlighting	floodlighting
floord	floored
flooring	flooring
flopd	flopped
flopping	flopping
florishd	flourished
flotd	floated
flouncd	flounced
flouncing	flouncing
floundering	floundering
floundrd	floundered
flourishing	flourishing
floutd	flouted
flouting	flouting
flowering	flowering
flowing	flowing
flowrd	flowered
flrtd	flirted
fluctu8d	fluctuated
fluctuating	fluctuating
flufd	fluffed
fluffing	fluffing
flunkd	flunked
flunking	flunking
flushd	flushed
flushing	flushing
fluting	fluting
flutrd	fluttered
fluttering	fluttering
flying	flying
fmly	family
fnancd	financed
fnd	find
fndtn	foundation
fnshd	finished
foald	foaled
foaling	foaling
foaming	foaming
focusd	focused
focusin	focusing
fogd	fogged
fogin	fogging
foild	foiled
foilin	foiling
foistd	foisted
foistin	foisting
foldd	folded
foldin	folding
follwd	followed
fomed	foamed
fomentd	fomented
fomenting	fomenting
fondld	fondled
fondling	fondling
fone	phone
fonin	phoning
foold	fooled
foold	fooled
fooling	fooling
footballing	footballing
footd	footed
footing	footing
fosilisd	fossilised
fosilizd	fossilized
fossilising	fossilising
fossilizing	fossilizing
fostering	fostering
fostrd	fostered
foto	photo
fotocopyin	photocopying
fotofinishin	photofinishing
fotoing	photographing
fotoshopin	photoshopping
fouled	fouled
fouling	fouling
foundd	founded
foundering	foundering
founding	founding
foundling	foundling
foundrd	foundered
fracturd	fractured
fracturing	fracturing
fragmenting	fragmenting
fragmntd	fragmented
framd	framed
framing	framing
franchisd	franchised
franchising	franchising
franking	franking
frasin	phrasing
fraternising	fraternising
fraternizing	fraternizing
frayd	frayed
fraying	fraying
freakd	freaked
freaking	freaking
freeing	freeing
freelancing	freelancing
freestanding	freestanding
freewheeling	freewheeling
freezing	freezing
frequentd	frequented
frequenting	frequenting
freshend	freshened
freshening	freshening
freshnd	freshened
fretd	fretted
frettd	fretted
fretting	fretting
fri	Friday
frigging	frigging
frightend	frightened
frightening	frightening
fringing	fringing
friskd	frisked
friskd	frisked
frisking	frisking
friterd	frittered
fritterd	frittered
frittering	frittering
frm	from
frmentd	fermented
frnd	friend
frnds	friends
frolickd	frolicked
frolicking	frolicking
frolikd	frolicked
frontd	fronted
frontd	fronted
fronting	fronting
frostd	frosted
frostd	frosted
frosting	frosting
frothd	frothed
frothd	frothed
frothing	frothing
frownd	frowned
frownd	frowned
frowning	frowning
fruiting	fruiting
frustr8d	frustrated
frustr8d	frustrated
frustrating	frustrating
fryd	fried
frying	frying
frytend	frightened
fst	fast
ftac	fantasy
ftbl	football
fudgd	fudged
fudged	fudged
fudging	fudging
fueld	fuelled
fuelld	fuelled
fuelling	fuelling
fulfild	fulfilled
fulfilld	fulfilled
fulfillin	fulfilling
fulminatin	fulminating
fumbld	fumbled
fumbled	fumbled
fumblin	fumbling
fumd	fumed
fumed	fumed
fumig8td	fumigated
fumigatd	fumigated
fumigatin	fumigating
fumin	fuming
functiond	functioned
functiond	functioned
functionin	functioning
fundd	funded
fundholdin	fundholding
fundin	funding
fundraisin	fundraising
fune	funny
funneld	funnelled
funneld	funnelled
funnellin	funnelling
furld	furled
furld	furled
furlin	furling
furloughd	furloughed
furloughd	furloughed
furloughin	furloughing
furnishd	furnished
furnishd	furnished
furnishin	furnishing
furrd	furred
furrin	furring
furtherd	furthered
furtherd	furthered
furtherin	furthering
fusd	fused
fusin	fusing
fussd	fussed
fussd	fussed
fussin	fussing
futr	future
fyi	for your information
fwd	forward
g2g	got to go
g8crashin	gatecrashing
ga	go ahead
gabblin	gabbling
gagd	gagged
gaggin	gagging
gaind	gained
gainin	gaining
gainsayin	gainsaying
galivantd	gallivanted
galld	galled
gallin	galling
gallivanti	gallivanting
gallopd	galloped
gallopin	galloping
galvanisd	galvanised
galvanisin	galvanising
galvanizd	galvanized
galvanizin	galvanizing
gambld	gambled
gambling	gambling
gambollin	gambolling
gamin	gaming
gangd	ganged
gangin	ganging
ganglin	gangling
gaped	gaped
gapin	gaping
gardenin	gardening
gargld	gargled
garglin	gargling
garnerd	garnered
garnerin	garnering
garnishd	garnished
garnishin	garnishing
garrottin	garrotting
gasd	gassed
gashd	gashed
gashin	gashing
gaspd	gasped
gaspin	gasping
gassin	gassing
gatherd	gathered
gatherin	gathering
gauged	gauged
gaugin	gauging
gawkin	gawking
gazd	gazed
gazin	gazing
gazumpin	gazumping
gdi	god damn it
geard	geared
gearin	gearing
geldin	gelding
generalisin	generalising
generalizin	generalizing
generatin	generating
gentrifyin	gentrifying
gesticul8d	gesticulated
gesticulatin	gesticulating
gesturd	gestured
gesturin	gesturing
gettin	getting
gettin	getting
gf	girlfriend
gfi	go for it
gg	good game
ggle	google
ghosti	ghosting
gibberin	gibbering
giberd	gibbered
gigglin	giggling
gigled	giggled
gildd	gilded
gildin	gilding
gimme	give me
girdd	girded
girdin	girding
girdld	girdled
girdlin	girdling
giv	give
givin	giving
givn	given
givs	gives
gj	good job
gl	good luck
gla	glasgow
gladdenin	gladdening
gladend	gladdened
glancin	glancing
glansd	glanced
glared	glared
glarin	glaring
glazd	glazed
glazin	glazing
glbl	global
gleamd	gleamed
gleamin	gleaming
gleand	gleaned
gleanin	gleaning
glided	glided
glidin	gliding
glimerd	glimmered
glimerin	glimmering
glimpsd	glimpsed
glimpsin	glimpsing
glintd	glinted
glintin	glinting
glistenin	glistening
glistnd	glistened
gliterd	glittered
glitterin	glittering
gloamin	gloaming
gloatd	gloated
gloating	gloating
glorifyin	glorifying
gloryin	glorying
glosd	glossed
glossin	glossing
glowd	glowed
glowerin	glowering
glowin	glowing
glued	glued
gluin	gluing
gm	good move
gnawd	gnawed
gnawin	gnawing
gnight	goodnight
gnr8	generate
gnr8d	generated
gnr8n	generation
gnrlisd	generalised
gnrlizd	generalized
goaded	goaded
goadin	goading
goalkeepin	goalkeeping
gobblin	gobbling
gobld	gobbled
godalmin	godalming
goerin	goering
gogglin	goggling
gogled	goggled
goin	going
goin	going
goldin	golding
golfin	golfing
gona	gonna
goodin	gooding
googled	googled
googlin	googling
gorged	gorged
gorgin	gorging
gosipd	gossiped
goslin	gosling
gossipin	gossiping
gostd	ghosted
gota	gotta
gouged	gouged
gougin	gouging
gouldin	goulding
gov	government
governin	governing
govrnd	governed
gowi	get on with it
gr&d	grand
gr8	great
gr8d	grated
gr8ful	grateful
grabbin	grabbing
grabd	grabbed
graced	graced
gracin	gracing
gradin	grading
gradu8d	graduated
graduatin	graduating
graftd	grafted
graftin	grafting
grandfatherd	grandfathered
grandfatherin	grandfathering
grandstandin	grandstanding
grantd	granted
grantin	granting
grapled	grappled
grapplin	grappling
graspd	grasped
graspin	grasping
gratifyin	gratifying
gratin	grating
gravit8d	gravitated
gravitatin	gravitating
graylin	grayling
grazd	grazed
grazin	grazing
greasd	greased
greasin	greasing
greenin	greening
greetd	greeted
greetin	greeting
greyin	greying
grievd	grieved
grievin	grieving
grilld	grilled
grillin	grilling
grimacin	grimacing
grimasd	grimaced
grindin	grinding
grinnd	grinned
grinnin	grinning
gripd	gripped
griped	griped
gripin	griping
grippin	gripping
grittd	gritted
grittin	gritting
grl	girl
groand	groaned
groanin	groaning
groomd	groomed
groomin	grooming
gropd	groped
gropin	groping
grossd	grossed
grossin	grossing
groundbreakin	groundbreaking
groundd	grounded
groundin	grounding
grousd	groused
grousin	grousing
groutin	grouting
grovelled	grovelled
grovellin	grovelling
growin	growing
growlin	growling
grubbin	grubbing
grubd	grubbed
grudgin	grudging
gruellin	gruelling
grumbld	grumbled
grumblin	grumbling
gruntd	grunted
gruntin	grunting
grup	group
grupd	grouped
grupin	grouping
gt	good try
guaranteein	guaranteeing
guardin	guarding
gud	good
gudlukin	good-looking
gues	guess
guesin	guessing
guestin	guesting
guidin	guiding
guillotinin	guillotining
gulpin	gulping
gummin	gumming
gunnin	gunning
gurglin	gurgling
gushin	gushing
gustin	gusting
gutterin	guttering
guttin	gutting
guzzlin	guzzling
gyratin	gyrating
gys	guys
h8	hate
hackin	hacking
hadnt	had not
haemorrhagin	haemorrhaging
hagglin	haggling
hailin	hailing
hairdressin	hairdressing
hallucinatin	hallucinating
haltin	halting
halvin	halving
hammerin	hammering
hamperin	hampering
hamrd	hammered
hamstrin	hamstring
handcuffin	handcuffing
handholdin	handholding
handicappin	handicapping
handin	handing
handlin	handling
handwritin	handwriting
hangin	hanging
hankerin	hankering
hapi	happy
hapnd	happened
happenin	happening
haranguin	haranguing
harassin	harassing
harbourin	harbouring
hardenin	hardening
hardin	harding
hardworkin	hardworking
harin	haring
harkin	harking
harmin	harming
harmonisin	harmonising
harmonizin	harmonizing
harnessin	harnessing
harpin	harping
harrowin	harrowing
harryin	harrying
harvestin	harvesting
hashin	hashing
hasnt	has not
hasslin	hassling
hastenin	hastening
hatchin	hatching
hatin	hating
haulin	hauling
hauntin	haunting
hav	have
havent	have not
haverin	havering
havin	having
havin	having
havnt	haven't
hawkin	hawking
hayin	haying
hazardin	hazarding
hazin	hazing
headhuntin	headhunting
headin	heading
headlinin	headlining
healin	healing
heapin	heaping
hearin	hearing
hearin	hearing
hearkenin	hearkening
heartbreakin	heartbreaking
heartenin	heartening
heatin	heating
heavin	heaving
hecklin	heckling
hectorin	hectoring
hed	head
hedgin	hedging
heedin	heeding
heftin	hefting
heightenin	heightening
hel	hell
he'll	he will
helpin	helping
hemmin	hemming
hennin	henning
heraldin	heralding
herd	heard
herdin	herding
herrin	herring
hesitatin	hesitating
hewin	hewing
hf	have fun
hibernatin	hibernating
hidin	hiding
highlightin	highlighting
hijackin	hijacking
hikin	hiking
hinderin	hindering
hinin	hinging
hintin	hinting
hirin	hiring
hissin	hissing
hitchhikin	hitchhiking
hitchin	hitching
hittin	hitting
hivin	hiving
hlf	half
hlp	help
hme	home
hmslf	himself
hnd	hand
hndhld	handheld
hndst	handset
hoardin	hoarding
hoaxin	hoaxing
hobblin	hobbling
hobnobbin	hobnobbing
hockin	hocking
hoein	hoeing
hoggin	hogging
hoistin	hoisting
holdin	holding
holdin	holding
holidayin	holidaying
holin	holing
hollerin	hollering
homecomin	homecoming
homesteadin	homesteading
homin	homing
homogenisin	homogenising
homogenizin	homogenizing
honin	honing
honkin	honking
honourin	honouring
hoodwinkin	hoodwinking
hookin	hooking
hootin	hooting
hopin	hoping
hoppin	hopping
horrifyin	horrifying
horsin	horsing
hosin	hosing
hostin	hosting
houndin	hounding
housebreakin	housebreaking
housebuildin	housebuilding
housecleanin	housecleaning
housekeepin	housekeeping
housemovin	housemoving
housin	housing
housin	housing
hoverin	hovering
howlin	howling
hpe	hope
hpn	happen
hpnd	happened
hpnin	happening
hr	hour
hrd	hard
hrdwr	hardware
hre	here
hrs	hours
hrslf	herself
hstry	history
ht	hi there
huddlin	huddling
huffin	huffing
huggin	hugging
hulkin	hulking
humanisin	humanising
humanizin	humanizing
humblin	humbling
humiliatin	humiliating
hummin	humming
humourin	humouring
humpin	humping
humr	humour
hunchin	hunching
hungerin	hungering
huntin	hunting
hurdlin	hurdling
hurlin	hurling
hurryin	hurrying
hurtin	hurting
hurtlin	hurtling
hushin	hushing
hustlin	hustling
hw	how
hwevr	however
hwk	homework
hyperventilatin	hyperventilating
hyphenatin	hyphenating
hypin	hyping
hypnotisin	hypnotising
hypnotizin	hypnotizing
hypothesisin	hypothesising
hypothesizin	hypothesizing
ic	i see
icebreakin	icebreaking
icin	icing
i'd	I would
idealisin	idealising
idealizin	idealizing
identifyin	identifying
idlin	idling
ignitin	igniting
ignorin	ignoring
i'll	i will
illuminatin	illuminating
illustratin	illustrating
im	i am
imagin	imaging
imaginin	imagining
imbibin	imbibing
imitatin	imitating
immersin	immersing
immigratin	immigrating
immobilisin	immobilising
imo	in my opinion
imp	important
impactin	impacting
impairin	impairing
impalin	impaling
impartin	imparting
impeachin	impeaching
impedin	impeding
impellin	impelling
impendin	impending
impersonatin	impersonating
impinin	impinging
implantin	implanting
implementin	implementing
implicatin	implicating
implmnt	implement
implmnting	implementing
implodin	imploding
implorin	imploring
implyin	implying
importin	importing
imposin	imposing
impoundin	impounding
impoverishin	impoverishing
impregnatin	impregnating
impressin	impressing
imprintin	imprinting
imprisonin	imprisoning
improvin	improving
improvin	improving
improvisin	improvising
imprtnce	importance
imprtnt	important
impssible	impossible
impugnin	impugning
imputin	imputing
in2	into
in4md	informed
in4min	informing
inauguratin	inaugurating
inbreedin	inbreeding
incapacitatin	incapacitating
incarceratin	incarcerating
incensin	incensing
inchin	inching
incineratin	incinerating
incitin	inciting
incld	include
incldin	including
inclinin	inclining
includin	including
incomin	incoming
inconveniencin	inconveniencing
incorporatin	incorporating
increasin	increasing
incriminatin	incriminating
incubatin	incubating
inculcatin	inculcating
incurrin	incurring
indemnifyin	indemnifying
indentin	indenting
indexin	indexing
indic8d	indicated
indic8in	indicating
indictd	indicted
indictin	indicting
individualisd	individualised
individualisin	individualising
indoctrin8d	indoctrinated
indoctrinatin	indoctrinating
indstrialisd	industrialised
indstrializd	industrialized
indstry	industry
inducd	induced
inducin	inducing
indulgd	indulged
indulgin	indulging
industrialisin	industrialising
industrializin	industrializing
inestin	ingesting
infectd	infected
infectin	infecting
inferrd	inferred
inferrin	inferring
infestd	infested
infestin	infesting
infightin	infighting
infillin	infilling
infiltr8d	infiltrated
infiltratin	infiltrating
infl8d	inflated
inflamd	inflamed
inflamin	inflaming
inflatin	inflating
inflectd	inflected
inflectin	inflecting
inflictd	inflicted
inflictin	inflicting
influencd	influenced
influencin	influencing
info	information
infrinin	infringing
infuri8d	infuriated
infuriatin	infuriating
infusd	infused
infusin	infusing
inhabitd	inhabited
inhabitin	inhabiting
inhald	inhaled
inhalin	inhaling
inheritd	inherited
inheritin	inheriting
inhibitd	inhibited
inhibitin	inhibiting
initi8	initiate
initi8d	initiated
initiatin	initiating
injectd	injected
injectin	injecting
injurd	injured
injurin	injuring
inkd	inked
inkin	inking
inklin	inkling
innin	inning
innov8d	innovated
innov8ion	innovation
innov8in	innovating
inocul8d	inoculated
inocul8in	inoculating
inputtin	inputting
inquird	inquired
inquirin	inquiring
inratiatin	ingratiating
inscribd	inscribed
inscribin	inscribing
insertd	inserted
insertin	inserting
insinu8d	insinuated
insinu8in	insinuating
insistd	insisted
insistin	insisting
inspectd	inspected
inspectin	inspecting
inspird	inspired
inspirin	inspiring
installd	installed
installin	installing
instig8d	instigated
instigatin	instigating
instilld	instilled
instillin	instilling
institutd	instituted
institutin	instituting
instructd	instructed
instructin	instructing
insul8d	insulated
insul8in	insulating
insultd	insulted
insultin	insulting
insurd	insured
insurin	insuring
integr8	integrate
integr8d	integrated
integr8in	integrating
intendin	intending
intensifyin	intensifying
interactd	interacted
interactin	interacting
interbreedin	interbreeding
intercedd	interceded
intercedin	interceding
interceptd	intercepted
interceptin	intercepting
interchangd	interchanged
interchangin	interchanging
interdictd	interdicted
interdictin	interdicting
interestd	interested
interestin	interesting
interfacd	interfaced
interfacin	interfacing
interfeed	interfered
interferin	interfering
interjeced	interjected
interjectin	interjecting
interlacd	interlaced
interlacin	interlacing
interlockd	interlocked
interlockin	interlocking
interminlin	intermingling
internalisd	internalised
internalisin	internalising
internalizd	internalized
internalizin	internalizing
internd	interned
internin	interning
interpol8d	interpolated
interpolatin	interpolating
interposd	interposed
interposin	interposing
interpretd	interpreted
interpretin	interpreting
interro8	interrogate
interrog8d	interrogated
interrog8in	interrogating
interruptd	interrupted
interruptin	interrupting
intersectd	intersected
intersectin	intersecting
interspersd	interspersed
interspersin	interspersing
intertwind	intertwined
intertwinin	intertwining
intervend	intervened
intervenin	intervening
intgr8	integrate
intim8d	intimated
intim8in	intimating
intimid8	intimidate
intimid8d	intimidated
intimidatin	intimidating
intl	international
intllgnce	intelligence
intllgnt	intelligent
intond	intoned
intonin	intoning
intoxic8d	intoxicated
intoxicatin	intoxicating
intrfce	interface
intriguin	intriguing
intrnt	internet
intro	introduction
introducd	introduced
introducin	introducing
introspectin	introspecting
intrstn	interesting
intrudin	intruding
intrvw	interview
intrvwin	interviewing
intrvwd	interviewed
inundatin	inundating
invadin	invading
invalid8d	invalidated
invalidatin	invalidating
inveighin	inveighing
inveigled	inveigled
inveiglin	inveigling
inventd	invented
inventin	inventing
inverkeithin	inverkeithing
invertd	inverted
invertin	inverting
investd	invested
investig8d	investigated
investigatin	investigating
investin	investing
invigil8d	invigilated
invigilatin	invigilating
invigor8d	invigorated
invigoratin	invigorating
invitd	invited
invitin	inviting
invoicd	invoiced
invoicin	invoicing
invokd	invoked
invokin	invoking
involvd	involved
involvin	involving
invsbl	invisible
ionisd	ionised
ionisin	ionising
ionizd	ionized
ionizin	ionizing
iou	i owe you
iphn	iphone
irond	ironed
ironin	ironing
irradi8d	irradiated
irradiatin	irradiating
irrig8d	irrigated
irrigatin	irrigating
irrit8	irritate
irrit8d	irritated
irritatin	irritating
irvin	irving
islnd	island
isol8	isolate
isol8d	isolated
isolatin	isolating
issud	issued
issuin	issuing
itchd	itched
itchin	itching
itemisd	itemised
itemisin	itemising
ive	i have
jabbd	jabbed
jabberd	jabbered
jabberin	jabbering
jabbin	jabbing
jackd	jacked
jackin	jacking
jaild	jailed
jailin	jailing
jammd	jammed
jammin	jamming
jan	january
jangld	jangled
janglin	jangling
jarrd	jarred
jarrin	jarring
jauntin	jaunting
jawbonin	jawboning
jaywalkin	jaywalking
jeerd	jeered
jeerin	jeering
jeopardisd	jeopardised
jeopardisin	jeopardising
jeopardizd	jeopardized
jeopardizin	jeopardizing
jerkd	jerked
jerkin	jerking
jettd	jetted
jettin	jetting
jettisond	jettisoned
jettisonin	jettisoning
jiggd	jigged
jiggin	jigging
jiggld	jiggled
jigglin	jiggling
jiltd	jilted
jiltin	jilting
jinlin	jingling
jobbin	jobbing
jockeyd	jockeyed
jockeyin	jockeying
joggd	jogged
joggin	jogging
joind	joined
joinin	joining
jointin	jointing
jokd	joked
jokin	joking
joltd	jolted
joltin	jolting
jostld	jostled
jostlin	jostling
jottd	jotted
jottin	jotting
journeyd	journeyed
journeyin	journeying
joustin	jousting
joyridin	joyriding
jst	just
judderd	juddered
judderin	juddering
judgd	judged
judgin	judging
juggld	juggled
jugglin	juggling
jul	july
jumpd	jumped
jumpin	jumping
junkd	junked
junkin	junking
justifyin	justifying
juttd	jutted
juttin	jutting
juxtaposd	juxtaposed
juxtaposin	juxtaposing
k	ok
kayakin	kayaking
kbd	keyboard
kds	kids
keatin	keating
keeld	keeled
keelin	keeling
keenin	keening
keepin	keeping
kennellin	kennelling
ketterin	kettering
keyd	keyed
keyin	keying
keystrokin	keystroking
kickd	kicked
kickin	kicking
kiddin	kidding
kidnappd	kidnapped
kidnappin	kidnapping
killd	killed
killin	killing
kilwinnin	kilwinning
kindld	kindled
kindlin	kindling
kiplin	kipling
kissd	kissed
kissin	kissing
kittin	kitting
knd	kind
kndly	kindly
kneadin	kneading
kneelin	kneeling
knifin	knifing
knittd	knitted
knittin	knitting
knockd	knocked
knockin	knocking
knottd	knotted
knottin	knotting
knowin	knowing
knuckld	knuckled
knucklin	knuckling
knw	know
knwin	knowing
kowtowin	kowtowing
krnl	kernel
kul	cool
kunmin	kunming
kwakin	quacking
l8	late
l8r	later
labelld	labelled
labellin	labelling
labourd	laboured
labourin	labouring
lacer8d	lacerated
laceratin	lacerating
lacin	lacing
lackd	lacked
lackin	lacking
lactatin	lactating
ladin	lading
ladled	ladled
ladlin	ladling
laggd	lagged
laggin	lagging
lambastd	lambasted
lambastin	lambasting
lambin	lambing
lamentd	lamented
lamentin	lamenting
lamin	laming
lammin	lamming
lampoond	lampooned
lampoonin	lampooning
lancd	lanced
lancin	lancing
landholdin	landholding
landin	landing
landownin	landowning
landscapd	landscaped
landscapin	landscaping
lang	language
langs	languages
languishd	languished
languishin	languishing
lannin	lanning
lansin	lansing
lappd	lapped
lappin	lapping
lapsd	lapsed
lapsin	lapsing
lapwin	lapwing
larkin	larking
lashd	lashed
lashin	lashing
lassoin	lassoing
lastd	lasted
lastin	lasting
latchd	latched
latchin	latching
laudin	lauding
laughd	laughed
laughin	laughing
launchd	launched
launchin	launching
launderd	laundered
launderin	laundering
lavishd	lavished
lavishin	lavishing
lawmakin	lawmaking
layerd	layered
layerin	layering
layin	laying
lazin	lazing
lch	lunch
lck	luck
leachd	leached
leachin	leaching
leadd	leaded
leadin	leading
leafin	leafing
leakd	leaked
leakin	leaking
leand	leaned
leanin	leaning
leapd	leaped
leapfroggd	leapfrogged
leapfroggin	leapfrogging
leapin	leaping
learnd	learned
learnin	learning
leasd	leased
leashd	leashed
leashin	leashing
leasin	leasing
leav	leave
leavend	leavened
leavenin	leavening
leavin	leaving
lecturd	lectured
lecturin	lecturing
leerin	leering
legalisd	legalised
legalisin	legalising
legalizd	legalized
legalizin	legalizing
leggd	legged
leggin	legging
legisl8in	legislating
legitm8in	legitimating
lemin	lemming
lemmin	lemming
lendin	lending
lendin	lending
lengthend	lengthened
lengthenin	lengthening
lern	learn
lernd	learned
lesenin	lessening
lessend	lessened
lessenin	lessening
leterin	lettering
letin	letting
letin	letting
letterd	lettered
letterin	lettering
lettin	letting
levelld	levelled
levellin	levelling
leveragd	leveraged
leveragin	leveraging
leverd	levered
leverin	levering
levit8d	levitated
levit8in	levitating
levitatin	levitating
levlin	levelling
levragin	leveraging
levrin	levering
levyin	levying
levyin	levying
lft	left
libelld	libelled
libellin	libelling
liber8	liberate
liber8d	liberated
liber8in	liberating
liberalisd	liberalised
liberalisin	liberalising
liberalizd	liberalized
liberalizin	liberalizing
liberatin	liberating
liberlisin	liberalising
liberlizin	liberalizing
liblin	libelling
licencd	licensed
licensin	licensing
lickd	licked
lickin	licking
lickin	licking
licnsin	licensing
lifesavin	lifesaving
lifesavin	lifesaving
liftd	lifted
liftin	lifting
liftin	lifting
lightd	lighted
lightend	lightened
lightenin	lightening
lightin	lighting
lightnin	lightning
liked	liked
likened	likened
likenin	likening
likin	liking
likin	liking
liknin	likening
lil	little
liltin	lilting
liltin	lilting
limberin	limbering
limberin	limbering
limin	liming
limin	liming
limitd	limited
limitin	limiting
limitin	limiting
limpd	limped
limpin	limping
limpin	limping
linerin	lingering
lingerin	lingering
linin	lining
linin	lining
linkd	linked
linkin	linking
linkin	linking
liquid8d	liquidated
liquid8in	liquidating
liquidatin	liquidating
liquidisd	liquidised
liquidisin	liquidising
liquidisin	liquidising
liquorin	liquoring
liquorin	liquoring
lispd	lisped
lispin	lisping
lispin	lisping
listd	listed
listend	listened
listenin	listening
listenin	listening
listin	listing
listin	listing
listnin	listening
literin	littering
litig8d	litigated
litig8in	litigating
litigatin	litigating
litterd	littered
litterin	littering
livd	lived
livend	livened
livenin	livening
livin	living
livnin	livening
lke	like
lkwise	likewise
lndn	london
lng	long
lngthnin	lengthening
lnk	link
loadin	loading
loafin	loafing
loand	loaned
loanin	loaning
loathd	loathed
loathin	loathing
lobbin	lobbing
lobbyin	lobbying
lobin	lobbing
lobyin	lobbying
loc8d	located
loc8in	locating
localisd	localised
localisin	localising
localizin	localizing
lockd	locked
lockin	locking
lodgd	lodged
lodgin	lodging
loggd	logged
loggin	logging
loiterd	loitered
loiterin	loitering
lol	laughing out loud
lollin	lolling
longd	longed
longin	longing
longin	longing
longlastin	long-lasting
longstandin	longstanding
loomd	loomed
loomin	looming
loopd	looped
loopin	looping
loosend	loosened
loosin	loosing
loosnin	loosening
looted	looted
lootin	looting
loped	loped
lopin	loping
lopped	lopped
loppin	lopping
lordin	lording
lordin	lording
losin	losing
loungd	lounged
loungin	lounging
lovemakin	lovemaking
lovin	loving
lowerd	lowered
lowin	lowing
lowrin	lowering
lst	last
lubric8d	lubricated
lubric8in	lubricating
luggd	lugged
lugin	lugging
luk	look
lukd	looked
lukin	looking
lulin	lulling
lulld	lulled
lumberd	lumbered
lumberin	lumbering
lumpd	lumped
lumpin	lumping
lumpin	lumping
lunchd	lunched
lunchin	lunching
lungd	lunged
lungin	lunging
lungin	lunging
lurchd	lurched
lurchin	lurching
lurd	lured
lurin	luring
lurkd	lurked
lurkin	lurking
lustd	lusted
lustin	lusting
luv	love
luvd	loved
luvin	loving
luvmakin	lovemaking
luvu	love you
luxuri8in	luxuriating
luxuriatin	luxuriating
lve	live
lvrpl	liverpool
lyin	lying
lyk	like
lynchd	lynched
lynchin	lynching
lytin	lighting
lytnin	lightening
lytnin	lightning
m8	mate
m8in	mating
m8s	mates
machind	machined
machnin	machining
maddenin	maddening
madend	maddened
madnin	maddening
mag	magazine
magnfyin	magnifying
magnifyin	magnifying
maild	mailed
mailin	mailing
mailin	mailing
maimd	maimed
maimin	maiming
mainsprin	mainspring
maintaind	maintained
maintainin	maintaining
majord	majored
majorin	majoring
majorin	majoring
makin	making
malfunctiond	malfunctioned
malfunctionin	malfunctioning
malfunctionin	malfunctioning
malignd	maligned
malignin	maligning
malignin	maligning
malinerin	malingering
malingrin	malingering
maltd	malted
maltin	malting
mamin	maiming
managd	managed
managin	managing
mand8d	mandated
mand8in	mandating
mangld	mangled
manglin	mangling
manhandld	manhandled
manhandlin	manhandling
manifestd	manifested
manifestin	manifesting
manin	manning
manipul8d	manipulated
manipul8in	manipulating
mannd	manned
mannin	manning
manoeuvrd	manoeuvred
mansprin	mainspring
mantanin	maintaining
mantlin	mantling
manufacturd	manufactured
manufacturin	manufacturing
manurin	manuring
manurin	manuring
manuvrin	manoeuvring
mapin	mapping
mappd	mapped
maraudin	marauding
maraudin	marauding
marched	marched
marchin	marching
marginalisd	marginalised
margnalisin	marginalising
marin	marring
markd	marked
marketd	marketed
marketin	marketing
markin	marking
marlin	marling
maroond	marooned
maroonin	marooning
marrd	marred
marrin	marring
marryin	marrying
marshalin	marshalling
marshalld	marshalled
marshallin	marshalling
marvelld	marvelled
marvellin	marvelling
marvlin	marvelling
masacrin	massacring
mashd	mashed
mashin	mashing
maskd	masked
maskin	masking
maskradin	masquerading
masqueradd	masqueraded
massacrd	massacred
massacrin	massacring
massagd	massaged
massagin	massaging
massd	massed
massin	massing
masterd	mastered
masterin	mastering
mastermindd	masterminded
mastermindin	masterminding
mastic8in	masticating
masticatin	masticating
mastrb8in	masturbating
masturb8	masturbate
masturb8d	masturbated
matchd	matched
matchin	matching
matchmakin	matchmaking
matchmakin	matchmaking
materialisd	materialised
materialisin	materialising
materialisin	materialising
materin	mattering
matin	mating
matrcul8in	matriculating
matricul8d	matriculated
matterd	mattered
matterin	mattering
mattin	matting
maturin	maturing
maulin	mauling
maulin	mauling
maxed	maximized
maximised	maximised
maximisin	maximising
maximizin	maximizing
maximizin	maximizing
mayb	maybe
mch	much
mde	made
mdia	media
mdl	model
mdls	models
meanderd	meandered
meanderin	meandering
meanderin	meandering
meanin	meaning
meanin	meaning
measurd	measured
meatpackin	meatpacking
meatpackin	meatpacking
mechanisd	mechanised
mechanisin	mechanising
mechanizd	mechanized
mechanizin	mechanizing
meddld	meddled
medi8d	mediated
medi8in	mediating
medic8d	medicated
medic8in	medicating
medit8d	meditated
medit8in	meditating
medlin	meddling
meldd	melded
meldin	melding
mellowd	mellowed
melowin	mellowing
meltd	melted
meltin	melting
memorisd	memorised
memorisin	memorising
memorizd	memorized
memorizin	memorizing
menacd	menaced
menacin	menacing
mendin	mending
menstru8in	menstruating
menstruatin	menstruating
mentiond	mentioned
mentionin	mentioning
mentorin	mentoring
merchandisin	merchandising
mergd	merged
mergin	merging
meritd	merited
meritin	meriting
meritin	meriting
meshd	meshed
meshin	meshing
meshin	meshing
mesmerisd	mesmerised
mesmerisin	mesmerising
mesmerizd	mesmerized
mesmerizin	mesmerizing
messagin	messaging
messd	messed
messin	messing
mesurin	measuring
metalworkin	metalworking
meterd	metered
meterin	metering
meterin	metering
metin	meting
mewin	mewing
mght	might
microfilmin	microfilming
microwavd	microwaved
microwavin	microwaving
microwavin	microwaving
middlin	middling
midlin	middling
migr8d	migrated
migr8in	migrating
milit8d	militated
milit8in	militating
militatin	militating
milkd	milked
milkin	milking
millin	milling
millin	milling
mimd	mimed
mimickd	mimicked
mimickin	mimicking
mimikin	mimicking
mimin	miming
min	minute
mincd	minced
mincin	mincing
mindd	minded
mindin	minding
mindin	minding
minglin	mingling
miniaturisd	miniaturised
miniaturisin	miniaturising
miniaturisin	miniaturising
minimisd	minimised
minimisin	minimising
minimisin	minimising
minimizd	minimized
minimizin	minimizing
minin	mining
minin	mining
ministerd	ministered
ministerin	ministering
minlin	mingling
mins	minutes
mintd	minted
mintin	minting
mintin	minting
mirorin	mirroring
mirrord	mirrored
mirrorin	mirroring
misaplyin	misapplying
misappropriatin	misappropriating
misapropri8in	misappropriating
misbhavin	misbehaving
miscalcul8in	miscalculating
miscarryin	miscarrying
miscastin	miscasting
miscountin	miscounting
miscountin	miscounting
misdirectin	misdirecting
misdirectin	misdirecting
misgivin	misgiving
mishandlin	mishandling
mishearin	mishearing
mishearin	mishearing
mishitin	mishitting
mishittin	mishitting
misin	missing
misinterpretin	misinterpreting
misinterpretin	misinterpreting
misleadin	misleading
mismanagin	mismanaging
mismanagin	mismanaging
mismatchin	mismatching
mismatchin	mismatching
mispelin	misspelling
misplacin	misplacing
misplacin	misplacing
mispronouncin	mispronouncing
mispronouncin	mispronouncing
misquotin	misquoting
misquotin	misquoting
misreadin	misreading
misreadin	misreading
misrepresentin	misrepresenting
misrepresentin	misrepresenting
misspellin	misspelling
mistakin	mistaking
mistakin	mistaking
misted	misted
mistin	misting
mistreatin	mistreating
mistreatin	mistreating
mistrustin	mistrusting
mistrustin	mistrusting
misunderstandin	misunderstanding
misusin	misusing
misusin	misusing
mitig8d	mitigated
mitig8in	mitigating
mixed	mixed
mixin	mixing
mlln	million
mmurin	murmuring
mnchstr	manchester
mnd	mind
mndy	Monday
mnging	managing
mngment	management
mngr	manager
mngrs	managers
mnth	month
mny	many
moand	moaned
moanin	moaning
moanin	moaning
mobbin	mobbing
mobd	mobbed
mobilisd	mobilised
mobilisin	mobilising
mobilizd	mobilized
mobilizin	mobilizing
mobilizin	mobilizing
mobin	mobbing
mockd	mocked
mockin	mocking
modeld	modelled
modelin	modelling
moder8d	moderated
moder8in	moderating
modernisd	modernised
modernisin	modernising
modernizd	modernized
modernizin	modernizing
modfyin	modifying
modifd	modified
modifyin	modifying
modrnisin	modernising
modrnizin	modernizing
modul8d	modulated
modul8in	modulating
moing	mooing
moistend	moistened
moistenin	moistening
moistnin	moistening
moisturisin	moisturising
moisturisin	moisturising
molestd	molested
molestin	molesting
molestin	molesting
molifyin	mollifying
mollifyin	mollifying
moneymkin	moneymaking
monitord	monitored
monitorin	monitoring
monitorin	monitoring
monopolisd	monopolised
monopolisin	monopolising
monopolisin	monopolising
monopolizd	monopolized
monopolizin	monopolizing
monopolizin	monopolizing
mooin	mooing
moonin	mooning
moonin	mooning
moonlightd	moonlighted
moonlightin	moonlighting
moonlitin	moonlighting
moord	moored
moorin	mooring
moorin	mooring
mopin	moping
mopin	moping
moppin	mopping
moppin	mopping
mor	more
moralisd	moralised
moralisin	moralising
moralisin	moralising
moralizin	moralizing
moralizin	moralizing
mornin	morning
mornin	morning
mornin	morning
mortgagd	mortgaged
mortgagin	mortgaging
mortgagin	mortgaging
mortifyin	mortifying
mortifyin	mortifying
mothbalin	mothballing
mothballd	mothballed
mothballin	mothballing
motherd	mothered
motherin	mothering
motherin	mothering
motiond	motioned
motionin	motioning
motiv8d	motivated
motiv8in	motivating
motord	motored
motorin	motoring
motorin	motoring
mouldd	moulded
moulderin	mouldering
moulderin	mouldering
mouldin	moulding
moultin	moulting
moultin	moulting
moundin	mounding
moundin	mounding
mountainerin	mountaineering
mountd	mounted
mountin	mounting
mountin	mounting
mournd	mourned
mournin	mourning
mournin	mourning
mouthd	mouthed
mouthin	mouthing
mouthin	mouthing
mov	movie
movd	moved
movin	moving
movin	moving
mowd	mowed
mowin	mowing
mowin	mowing
mrch	march
mrket	market
mrktg	marketing
msappropri8d	misappropriated
msbehavd	misbehaved
mscalcul8d	miscalculated
mscountd	miscounted
msdirectd	misdirected
msg	message
msgin	messaging
msgs	messages
msjudgd	misjudged
msmanagd	mismanaged
msmatchd	mismatched
msplacd	misplaced
mspronouncd	mispronounced
msquotd	misquoted
msrepresentd	misrepresented
mss	miss
mssd	missed
msspelld	misspelled
mst	most
mstreatd	mistreated
mstrustd	mistrusted
mthd	method
mthds	methods
mtng	meeting
mu	miss you
muckd	mucked
muckin	mucking
muckin	mucking
muddld	muddled
muddlin	muddling
muddyin	muddying
mudlin	muddling
mudslinin	mudslinging
mudslinin	mudslinging
mudyin	muddying
muffld	muffled
muflin	muffling
muggd	mugged
muggin	mugging
mugin	mugging
mulchin	mulching
mulchin	mulching
mulin	mulling
mulld	mulled
mullin	mulling
multiplexin	multiplexing
multiplexin	multiplexing
multiplyin	multiplying
multiplyin	multiplying
multiprocesin	multiprocessing
multiprocessin	multiprocessing
multitaskin	multitasking
multitaskin	multitasking
mumbld	mumbled
mumblin	mumbling
mumblin	mumbling
munchd	munched
munchin	munching
murderd	murdered
murderin	murdering
murderin	murdering
murmurd	murmured
murmurin	murmuring
muscld	muscled
musclin	muscling
musclin	muscling
mushromin	mushrooming
mushroomd	mushroomed
musin	musing
musin	musing
musterd	mustered
musterin	mustering
mustnt	must not
mut8d	mutated
mut8in	mutating
mutatin	mutating
mutd	muted
muterin	muttering
mutil8d	mutilated
mutil8in	mutilating
mutilatin	mutilating
mutin	muting
mutin	muting
mutterd	muttered
mutterin	muttering
muzlin	muzzling
muzzld	muzzled
muzzlin	muzzling
myslf	myself
mystifyin	mystifying
mystifyin	mystifying
n	and
n1	nice one
na	not applicable
nabbd	nabbed
nabbin	nabbing
nabin	nabbing
nagd	nagged
naggin	nagging
nagin	nagging
naild	nailed
nailin	nailing
nailin	nailing
namd	named
namin	naming
namin	naming
nanjin	nanjing
nanjin	nanjing
napin	napping
nappd	napped
nappin	napping
nar8in	narrating
narowin	narrowing
narr8	narrate
narr8d	narrated
narratin	narrating
narrowd	narrowed
narrowin	narrowing
naterin	nattering
nationalizd	nationalized
nationalizin	nationalizing
nationalizin	nationalizing
natterin	nattering
nause8d	nauseated
nauseatin	nauseating
nauseatin	nauseating
navig8d	navigated
navig8in	navigating
navigatin	navigating
naybrin	neighbouring
nayin	neighing
ncase	in case
nce	nice
ncourage	encourage
ncouraged	encouraged
ncouragin	encouraging
nds	needs
ne	any
ne1	anyone
neard	neared
nearin	nearing
nearin	nearing
neatenin	neatening
neatnin	neatening
necesit8in	necessitating
necessit8d	necessitated
necessitatin	necessitating
neckd	necked
neckin	necking
nd	need
needd	needed
needin	needing
needld	needled
needlin	needling
needlin	needling
neg8d	negated
neg8in	negating
negatin	negating
neglectd	neglected
neglectin	neglecting
negoti8d	negotiated
negoti8in	negotiating
neighbourin	neighbouring
neighd	neighed
neighin	neighing
nekin	necking
nestd	nested
nestin	nesting
nestin	nesting
nestld	nestled
nestlin	nestling
nestlin	nestling
netin	netting
nettin	netting
networkd	networked
networkin	networking
netwrkin	networking
neuterin	neutering
neutralisd	neutralised
neutralisin	neutralising
neutralizd	neutralized
neutralizin	neutralizing
newspaperin	newspapering
ngage	engage
ngaged	engaged
ngagin	engaging
ngel	angel
ngtive	negative
nibbld	nibbled
nibblin	nibbling
niblin	nibbling
niggld	niggled
nigglin	niggling
niglin	niggling
nipin	nipping
nippd	nipped
nippin	nipping
nite	night
nitelife	nightlife
nitemare	nightmare
nitemares	nightmares
nites	nights
nitpickin	nitpicking
nitpikin	nitpicking
njoy	enjoy
njoyd	enjoyed
nlargd	enlarged
nlightend	enlightened
nlistd	enlisted
nly	only
nly1	only one
nme	name
no1	no one
no.1	number one
noddd	nodded
noddin	nodding
nodin	nodding
nomin8d	nominated
nomin8in	nominating
nominatin	nominating
nonbindin	nonbinding
nonbindin	nonbinding
nonper4min	nonperforming
nonrecurin	nonrecurring
nonrecurrin	nonrecurring
nonsmokin	non-smoking
nonsmokn	non-smoking
nonvotin	nonvoting
nonvotin	nonvoting
norishin	nourishing
norkopin	norrkoping
normalisd	normalised
normalisin	normalising
normalizd	normalized
normalizin	normalizing
normlisin	normalising
normlizin	normalizing
norrkopin	norrkoping
nosin	nosing
nosin	nosing
notchd	notched
notchin	notching
notchin	notching
notd	noted
notha	another
nothin	nothing
nothin	nothing
notic	notice
noticd	noticed
noticd	noticed
noticin	noticing
noticin	noticing
notifyin	notifying
notifyin	notifying
notin	noting
notin	noting
notisin	noticing
nottin	notting
nottin	notting
notwithstandin	notwithstanding
nourishd	nourished
nourishin	nourishing
nov	november
np	no problem
nrg	energy
nrthrn	northern
nt	nice try
nthin	nothing
ntwrk	network
nu	new
nudgd	nudged
nudgin	nudging
nuff	enough
nulifyin	nullifying
numbd	numbed
numberd	numbered
numberin	numbering
numbin	numbing
numbin	numbing
numbrin	numbering
nursd	nursed
nursin	nursing
nursin	nursing
nurturd	nurtured
nurturin	nurturing
nurturin	nurturing
nuterin	neutering
nutrlisin	neutralising
nutrlizin	neutralizing
nuzlin	nuzzling
nuzzld	nuzzled
nuzzlin	nuzzling
nvr	never
nw	no way
nws	news
nwspaprin	newspapering
nxt	next
ny	new york
o	of
obeyd	obeyed
obeyin	obeying
objctin	objecting
objectd	objected
objectin	objecting
obligd	obliged
obligin	obliging
obliter8d	obliterated
obliter8in	obliterating
obscurd	obscured
obscurin	obscuring
obscurin	obscuring
observd	observed
observin	observing
obsesin	obsessing
obsessd	obsessed
obsessin	obsessing
obsrvin	observing
obstructd	obstructed
obstructin	obstructing
obstructin	obstructing
obtaind	obtained
obtainin	obtaining
obtainin	obtaining
obtrudin	obtruding
obtrudin	obtruding
obvi8d	obviated
obvi8in	obviating
obviatin	obviating
occasiond	occasioned
occasionin	occasioning
occupyin	occupying
occurd	occurred
occurrin	occurring
oct	october
octiond	auctioned
octionin	auctioning
ocurin	occurring
oditin	auditing
oditiond	auditioned
oditionin	auditioning
odlin	odling
odlin	odling
ofendin	offending
oferin	offering
offended	offended
offendin	offending
offerd	offered
offerin	offering
offici8d	officiated
offici8in	officiating
offin	offing
offin	offing
offloadd	offloaded
offloadin	offloading
offlodin	offloading
offputin	off-putting
offputtin	off-putting
offsettin	offsetting
offsprin	offspring
offsprin	offspring
ofis	office
ofsetin	offsetting
oftn	often
ogld	ogled
oglin	ogling
oglin	ogling
ogmentd	augmented
ogmentin	augmenting
oild	oiled
oilin	oiling
oilin	oiling
ok	okay
okasionin	occasioning
okupyin	occupying
omg	oh my god
omitd	omitted
omitin	omitting
oncomin	oncoming
ongoin	ongoing
ongoin	ongoing
oozin	oozing
opend	opened
openin	opening
openin	opening
oper8d	operated
oper8in	operating
operatin	operating
opinin	opining
opn	open
opnd	opened
oposin	opposing
opp	opportunity
opposd	opposed
opposin	opposing
oppressd	oppressed
oppressin	oppressing
opps	opportunities
opresin	oppressing
optd	opted
optimisd	optimised
optimisin	optimising
optimizd	optimized
optimizin	optimizing
optin	opting
optin	opting
optmstc	optimistic
orbitd	orbited
orbitin	orbiting
orbitin	orbiting
orchestr8d	orchestrated
orchestratin	orchestrating
orda	order
ordaind	ordained
ordainin	ordaining
ordainin	ordaining
orderd	ordered
orderin	ordering
orderin	ordering
organisd	organised
organisin	organising
organizd	organized
organizin	organizing
orgnizn	organizing
orientd	oriented
orienteerin	orienteering
orientin	orienting
orientin	orienting
origin8d	originated
origin8in	originating
originatin	originating
orkestr8in	orchestrating
ornamentd	ornamented
ornamentin	ornamenting
ornamentin	ornamenting
oscil8in	oscillating
oscill8d	oscillated
oscillatin	oscillating
osum	awesome
othenticatin	authenticating
othord	authored
othorin	authoring
othorisd	authorised
othorisin	authorising
othorities	authorities
othorizd	authorized
othorizin	authorizing
othr	other
othrs	others
otografd	autographed
otografin	autographing
otom8d	automated
otomatin	automating
otomtclly	automatically
ourslvs	ourselves
oustd	ousted
oustin	ousting
oustin	ousting
outbiddin	outbidding
outbidin	outbidding
outbildin	outbuilding
outdoin	outdoing
outfitin	outfitting
outfittd	outfitted
outfittin	outfitting
outgoin	outgoing
outgoin	outgoing
outgroin	outgrowing
outgrowin	outgrowing
outin	outing
outin	outing
outlawd	outlawed
outlawin	outlawing
outlawin	outlawing
outlind	outlined
outlinin	outlining
outlinin	outlining
outlivd	outlived
outlivin	outliving
outlivin	outliving
outlyin	outlying
outlyin	outlying
outnumberd	outnumbered
outnumberin	outnumbering
outnumbrin	outnumbering
outpacd	outpaced
outpacin	outpacing
outpacin	outpacing
outper4md	outperformed
outper4min	outperforming
outpointd	outpointed
outpointin	outpointing
outpointin	outpointing
outpourin	outpouring
outpourin	outpouring
outputin	outputting
outputtin	outputting
outragd	outraged
outragin	outraging
outragin	outraging
outrunin	outrunning
outrunnin	outrunning
outsde	outside
outselin	outselling
outsellin	outselling
outshinin	outshining
outshinin	outshining
outsorcin	outsourcing
outsourcd	outsourced
outsourcin	outsourcing
outspendin	outspending
outspending	outspending
outstandin	outstanding
outstandin	outstanding
outstripin	outstripping
outstrippin	outstripping
outweighd	outweighed
outweighin	outweighing
outweighin	outweighing
outwitin	outwitting
outwittin	outwitting
outworkin	outworking
outwrkin	outworking
ovr	over
overachievin	overachieving
overactd	overacted
overactin	overacting
overarchin	overarching
overbearin	overbearing
overbuildin	overbuilding
overburdenin	overburdening
overcharged	overcharged
overchargin	overcharging
overcomin	overcoming
overcrowdin	overcrowding
overdoin	overdoing
overdosin	overdosing
overeatin	overeating
overestim8d	overestimated
overestimatin	overestimating
overfishin	overfishing
overflowin	overflowing
overflyin	overflying
overgrazin	overgrazing
overgrowin	overgrowing
overhangin	overhanging
overhauld	overhauled
overhaulin	overhauling
overheatd	overheated
overheatin	overheating
overlapd	overlapped
overlappin	overlapping
overlayin	overlaying
overloadin	overloading
overlookd	overlooked
overlukin	overlooking
overlyin	overlying
overmanned	overmanned
overmannin	overmanning
overpayin	overpaying
overplayd	overplayed
overplayin	overplaying
overpowerd	overpowered
overpowerin	overpowering
overpricd	overpriced
overpricin	overpricing
overproducd	overproduced
overproducin	overproducing
overreachd	overreached
overreachin	overreaching
overreactd	overreacted
overreactin	overreacting
overridin	overriding
overruld	overruled
overrulin	overruling
overrunnin	overrunning
overseein	overseeing
oversellin	overselling
overshadowd	overshadowed
overshadowin	overshadowing
overshootin	overshooting
oversimplifyin	oversimplifying
overspendin	overspending
overst8d	overstated
overstaffed	overstaffed
overstaffin	overstaffing
overstatin	overstating
overstepd	overstepped
oversteppin	overstepping
overstockd	overstocked
overstockin	overstocking
overstrainin	overstraining
overtakin	overtaking
overthrowin	overthrowing
overturnd	overturned
overturnin	overturning
overvaluin	overvaluing
overweenin	overweening
overwhelmed	overwhelmed
overwhelmin	overwhelming
overwintered	overwintered
overwinterin	overwintering
overworkd	overworked
overworkin	overworking
overwritin	overwriting
ovrachivin	overachieving
ovracting	overacting
ovrarchin	overarching
ovrbearin	overbearing
ovrbildin	overbuilding
ovrburdnin	overburdening
ovrchargin	overcharging
ovrcomin	overcoming
ovrcrowdin	overcrowding
ovrdoin	overdoing
ovrdosin	overdosing
ovreatin	overeating
ovrestim8in	overestimating
ovrfishin	overfishing
ovrfloin	overflowing
ovrflyin	overflying
ovrgrazin	overgrazing
ovrgroin	overgrowing
ovrhangin	overhanging
ovrhaulin	overhauling
ovrheatin	overheating
ovrlapin	overlapping
ovrlayin	overlaying
ovrlodin	overloading
ovrlukin	overlooking
ovrlyin	overlying
ovrmannin	overmanning
ovrpayin	overpaying
ovrplayin	overplaying
ovrpricin	overpricing
ovrproducin	overproducing
ovrpwrin	overpowering
ovrreachin	overreaching
ovrreactin	overreacting
ovrridin	overriding
ovrrulin	overruling
ovrrunnin	overrunning
ovrseein	overseeing
ovrselin	overselling
ovrshadowin	overshadowing
ovrshootin	overshooting
ovrsimplifyin	oversimplifying
ovrspendin	overspending
ovrst8in	overstating
ovrstafin	overstaffing
ovrstepin	overstepping
ovrstokin	overstocking
ovrstrainin	overstraining
ovrtakin	overtaking
ovrthrowin	overthrowing
ovrturnin	overturning
ovrvaluin	overvaluing
ovrweenin	overweening
ovrwhelmin	overwhelming
ovrwinterin	overwintering
ovrwrkin	overworking
ovrwrtin	overwriting
owd	owed
owin	owing
ownd	owned
ownin	owning
ownin	owning
oxidisd	oxidised
oxidisin	oxidising
oxidisin	oxidising
oxidizd	oxidized
oxidizin	oxidizing
oxidizin	oxidizing
oxygen8d	oxygenated
oxygenatin	oxygenating
oxygn8in	oxygenating
ozin	oozing
p8ntd	patented
p8ntin	patenting
p8ntin	patenting
pacifyin	pacifying
pacin	pacing
pacin	pacing
packagd	packaged
packagin	packaging
packd	packed
packin	packing
paddin	padding
paddled	paddled
paddlin	paddling
padin	padding
padlin	paddling
padlockd	padlocked
padlockin	padlocking
padlockin	padlocking
pagd	paged
pagin	paging
pagin8d	paginated
pagin8in	paginating
paind	pained
painin	paining
painkillin	painkilling
painstakin	painstaking
paintd	painted
paintin	painting
paird	paired
pairin	pairing
pakin	packing
pald	paled
palmd	palmed
palmin	palming
palmin	palming
palpit8d	palpitated
palpit8in	palpitating
pamperd	pampered
pamperin	pampering
pamperin	pampering
panderin	pandering
panderin	pandering
panelin	panelling
panellin	panelling
panhandlin	panhandling
panhandlin	panhandling
panickd	panicked
panickin	panicking
panikin	panicking
panin	panning
pankilin	painkilling
pannin	panning
pantin	panting
pantin	panting
paperd	papered
paperin	papering
paperin	papering
parachutd	parachuted
parachutin	parachuting
parachutin	parachuting
paradd	paraded
paradin	parading
paradin	parading
parafrasin	paraphrasing
paraglidin	paragliding
paraglidin	paragliding
paralelin	paralleling
paralleld	paralleled
parallelin	paralleling
paralysd	paralysed
paralysin	paralysing
paralysin	paralysing
parafrasd	paraphrased
parafrasin	paraphrasing
parchin	parching
parchin	parching
pardond	pardoned
pardonin	pardoning
parentin	parenting
parin	paring
parin	paring
parkd	parked
parkin	parking
parkin	parking
parleyin	parleying
parleyin	parleying
parodyin	parodying
parodyin	parodying
parotin	parroting
parrotin	parroting
parryin	parrying
parsin	parsing
parsin	parsing
partakin	partaking
partakin	partaking
partd	parted
particip8	participate
particip8d	participated
particip8in	participating
partin	parting
partitiond	partitioned
partitionin	partitioning
partnerd	partnered
partnerin	partnering
partnrin	partnering
partyin	partying
partyin	partying
paryin	parrying
pas	pass
pasin	passing
passin	passing
pastin	pasting
pastin	pasting
pasturd	pastured
pasturin	pasturing
pasturin	pasturing
patchd	patched
patchin	patching
patchin	patching
patd	patted
paterin	pattering
paternin	patterning
patin	patting
patrnisin	patronising
patrnizin	patronizing
patrold	patrolled
patrolin	patrolling
patrollin	patrolling
patronisd	patronised
patronisin	patronising
patronizd	patronized
patronizin	patronizing
patterd	pattered
patterin	pattering
patternd	patterned
patternin	patterning
pattin	patting
pausd	paused
pausin	pausing
pavin	paving
pawd	pawed
pawin	pawing
pawin	pawing
pawnd	pawned
pawnin	pawning
pawnin	pawning
payin	paying
peacekeepin	peacekeeping
peacekipin	peacekeeping
peacemakin	peacemaking
peacemkin	peacemaking
peakd	peaked
peakin	peaking
peaking	peaking
peald	pealed
pealin	pealing
pealin	pealing
peckd	pecked
peckin	pecking
peckin	pecking
pedalin	pedalling
pedalld	pedalled
pedallin	pedalling
peddld	peddled
peddlin	peddling
pedlin	peddling
peein	peeing
peein	peeing
peekd	peeked
peekin	peeking
peekin	peeking
peeld	peeled
peelin	peeling
peepd	peeped
peepin	peeping
peepin	peeping
peerd	peered
peerin	peering
peerin	peering
pegd	pegged
peggin	pegging
pegin	pegging
peltd	pelted
peltin	pelting
peltin	pelting
penalisd	penalised
penalisin	penalising
penalisin	penalising
penalizd	penalized
penalizin	penalizing
penalizin	penalizing
pencild	pencilled
penciling	pencilling
pencillin	pencilling
pendin	pending
penetr8d	penetrated
penetr8in	penetrating
penetratin	penetrating
penin	penning
pennin	penning
pensiond	pensioned
pensionin	pensioning
pensionin	pensioning
peperin	peppering
pepperd	peppered
pepperin	peppering
per4md	performed
per4min	performing
perambul8d	perambulated
perambul8in	perambulating
perambulatin	perambulating
perceivd	perceived
perceivin	perceiving
perchd	perched
perchin	perching
percol8d	percolated
percolatin	percolating
perfectd	perfected
perfectin	perfecting
perfumd	perfumed
perfumin	perfuming
perishd	perished
perishin	perishing
perishin	perishing
perkd	perked
perkin	perking
permeatd	permeated
permeatin	permeating
permitd	permitted
permittin	permitting
perpetr8d	perpetrated
perpetratin	perpetrating
perpetuatin	perpetuating
perplexd	perplexed
perplexin	perplexing
persecutd	persecuted
persecutin	persecuting
perseverd	persevered
perseverin	persevering
pershin	pershing
persistd	persisted
persistin	persisting
personalisd	personalised
personalisin	personalising
personalizd	personalized
personalizin	personalizing
personatin	personating
personifyin	personifying
perspirin	perspiring
persuadd	persuaded
persuadin	persuading
pertaind	pertained
pertainin	pertaining
perturbd	perturbed
perturbin	perturbing
perusd	perused
perusin	perusing
pervadin	pervading
pervertd	perverted
pervertin	perverting
pesterd	pestered
pesterin	pestering
peterd	petered
peterin	petering
peterin	petering
petifogin	pettifogging
petin	petting
petitiond	petitioned
petitionin	petitioning
petitionin	petitioning
petrifyin	petrifying
petrifyin	petrifying
pettifoggin	pettifogging
pettin	petting
pge	page
phasd	phased
phasin	phasing
filanderin	philandering
filosofisin	philosophising
filosofizin	philosophizing
phishin	phishing
phons	phones
phond	phoned
phonin	phoning
fotocopyin	photocopying
fotofinishin	photofinishing
fotografd	photographed
fotografin	photographing
fotoshopd	photoshopped
fotoshoppin	photoshopping
phrasd	phrased
phrasin	phrasing
pic	picture
pickd	picked
pickerin	pickering
picketd	picketed
picketin	picketing
pickin	picking
pickld	pickled
picklin	pickling
picnickd	picnicked
picnickin	picnicking
picnikin	picnicking
picturd	pictured
picturin	picturing
picturin	picturing
piddlin	piddling
pidlin	piddling
piecd	pieced
piecin	piecing
piecin	piecing
piercd	pierced
piercin	piercing
pikin	picking
piklin	pickling
pikrin	pickering
piktin	picketing
pilagin	pillaging
pilferin	pilfering
pilferin	pilfering
pilin	piling
pilin	piling
pillagd	pillaged
pillagin	pillaging
pilotd	piloted
pilotin	piloting
pilotin	piloting
pimpin	pimping
pimpin	pimping
pinchd	pinched
pinchin	pinching
pinchin	pinching
pinin	pining
pinin	pining
pinkd	pinked
pinkin	pinking
pinkin	pinking
pinnin	pinning
pinnin	pinning
pinpointd	pinpointed
pinpointin	pinpointing
pinpointin	pinpointing
pioneerd	pioneered
pioneerin	pioneering
pionerin	pioneering
pipin	piping
pippin	pipping
pir8d	pirated
pir8in	pirating
pircin	piercing
pirouetd	pirouetted
pirouettin	pirouetting
pirouetting	pirouetting
pitchd	pitched
pitchin	pitching
pitd	pitted
pitin	pitting
pittin	pitting
pityin	pitying
pivotd	pivoted
pivotin	pivoting
pkgin	packaging
pktin	pocketing
pl8	plate
pl8d	plated
pl8in	plating
plac8d	placated
placatin	placating
placd	placed
placin	placing
plagarisin	plagiarising
plagarizin	plagiarizing
plagiarisd	plagiarised
plaguin	plaguing
plaguin	plaguing
plak8tin	placating
pland	planned
planin	planing
planin	planning
planing	planing
plankin	planking
plantd	planted
plantin	planting
plantin	planting
plasterd	plastered
plasterin	plastering
plasterin	plastering
playd	played
playin	playing
playin	playing
playthin	plaything
playthin	plaything
playwritin	playwriting
playwritin	playwriting
plc	place
pleadin	pleading
pleasd	pleased
pleasin	pleasing
pledgd	pledged
pledgin	pledging
pledgin	pledging
plidin	pleading
pln	plain
plnng	planning
ploddin	plodding
plodin	plodding
plopin	plopping
ploppd	plopped
ploppin	plopping
plotd	plotted
plotin	plotting
plottin	plotting
ploughd	ploughed
ploughin	ploughing
ploughin	ploughing
pls	please
plsure	pleasure
plt4m	platform
plt4ms	platforms
pluckd	plucked
pluckin	plucking
pluggd	plugged
pluggin	plugging
plugin	plugging
plukin	plucking
plumbd	plumbed
plumbin	plumbing
plumetin	plummeting
plumin	plumbing
plummetd	plummeted
plummetin	plummeting
plumpd	plumped
plumpin	plumping
plumpin	plumping
plunderd	plundered
plunderin	plundering
plunderin	plundering
plungd	plunged
plungin	plunging
plungin	plunging
plunkd	plunked
plunkin	plunking
plunkin	plunking
plyin	plying
plyin	plying
plying	playing
plzin	pleasing
poachd	poached
poachin	poaching
poachin	poaching
pocketd	pocketed
pocketin	pocketing
pointd	pointed
pointin	pointing
pointin	pointing
pointin	pointing
poisd	poised
poisin	poising
poisin	poising
poisond	poisoned
poisonin	poisoning
pokd	poked
pokin	poking
polarisd	polarised
polarisin	polarising
polarizd	polarized
polarizin	polarizing
polarizin	polarizing
policd	policed
policin	policing
policin	policing
policymakin	policymaking
policymkin	policymaking
polin	poling
polin	poling
polin8in	pollinating
polishd	polished
polishin	polishing
politicisd	politicised
politicisin	politicising
politickin	politicking
politikin	politicking
polld	polled
pollin	polling
pollin	polling
pollin8d	pollinated
pollinatin	pollinating
pollutd	polluted
pollutin	polluting
polutin	polluting
ponderd	pondered
ponderin	pondering
ponderin	pondering
pontific8d	pontificated
pontific8in	pontificating
pontificatin	pontificating
poold	pooled
poolin	pooling
poolin	pooling
popin	popping
poppd	popped
poppin	popping
popul8d	populated
popularisd	popularised
popularisin	popularising
popularizd	popularized
popularizin	popularizing
populatin	populating
porin	poring
portendd	portended
portendin	portending
portendin	portending
portrayd	portrayed
portrayin	portraying
posin	posing
posin	posing
positin	positing
positin	positing
positiond	positioned
positionin	positioning
possessd	possessed
possessin	possessing
postd	posted
postin	posting
postin	posting
postpond	postponed
postponin	postponing
postponin	postponing
postul8d	postulated
postulatin	postulating
posturd	postured
posturin	posturing
posturin	posturing
pouncd	pounced
pouncin	pouncing
pouncin	pouncing
poundin	pounding
poundin	pounding
pourd	poured
pourin	pouring
pourin	pouring
poutd	pouted
poutin	pouting
poutin	pouting
pov	point of view
powa	power
powderd	powdered
powderin	powdering
powerd	powered
powerin	powering
ppl	people
ppul8in	populating
ppularisin	popularising
ppularizin	popularizing
practisd	practised
practisin	practising
praisd	praised
praisin	praising
praisin	praising
prancd	pranced
prancin	prancing
prancin	prancing
pratlin	prattling
prattld	prattled
prattlin	prattling
prayd	prayed
prayin	praying
prayin	praying
prbly	probably
prcedin	proceeding
prchin	perching
prcipit8in	precipitating
prcivin	perceiving
prcludin	precluding
prcol8in	percolating
prcrastin8in	procrastinating
prcsly	precisely
prctisin	practising
prdic8in	predicating
prdictin	predicting
prdomin8in	predominating
prducin	producing
preachd	preached
preachin	preaching
preachin	preaching
precedd	preceded
precedin	preceding
precedin	preceding
precipit8d	precipitated
precipitatin	precipitating
precludin	precluding
predic8d	predicated
predicatin	predicating
predictd	predicted
predictin	predicting
predisposd	predisposed
predisposin	predisposing
predisposin	predisposing
predomin8d	predominated
predominatin	predominating
preemptd	pre-empted
preemptin	pre-empting
preenin	preening
preenin	preening
prefacd	prefaced
prefacin	prefacing
preferrd	preferred
preferrin	preferring
prefixd	prefixed
prefixin	prefixing
prefrrin	preferring
preheatin	preheating
prejudgd	prejudged
prejudgin	prejudging
prejudicd	prejudiced
prejudicin	prejudicing
premierd	premiered
premierin	premiering
premptin	pre-empting
preoccupyin	preoccupying
prepard	prepared
preparin	preparing
prepayin	prepaying
presagd	presaged
presagin	presaging
prescribd	prescribed
prescribin	prescribing
presentd	presented
presentin	presenting
preservd	preserved
preservin	preserving
presetin	presetting
presettin	presetting
presidd	presided
presidin	presiding
presidin	presiding
presntin	presenting
presrvin	preserving
pressd	pressed
pressin	pressing
pressin	pressing
pressurd	pressured
pressurin	pressuring
pressurisd	pressurised
pressurisin	pressurising
pressurizd	pressurized
pressurizin	pressurizing
presumd	presumed
presumin	presuming
presupposd	presupposed
presupposin	presupposing
presurin	pressuring
pretendd	pretended
pretendin	pretending
prety	pretty
prevaild	prevailed
prevailin	prevailing
prevaric8d	prevaricated
prevaricatin	prevaricating
preventin	preventing
previewd	previewed
previewin	previewing
previuin	previewing
prevu	preview
preyd	preyed
preyin	preying
preying	preying
prfacin	prefacing
prfectin	perfecting
prferin	proffering
prfesin	professing
prfesyin	prophesying
prfilin	profiling
prfiterin	profiteering
prfitin	profiting
prfixin	prefixing
prfumin	perfuming
prgramin	programming
prgresin	progressing
prhaps	perhaps
prheatin	preheating
prhibitin	prohibiting
pricd	priced
pricin	pricing
pricin	pricing
prickd	pricked
prickin	pricking
prickld	prickled
pricklin	prickling
prikin	pricking
priklin	prickling
primd	primed
primin	priming
primin	priming
primry	primary
printd	printed
printin	printing
printmakin	printmaking
prioritisd	prioritised
prioritisin	prioritising
prioritisin	prioritising
prioritizin	prioritizing
prioritizin	prioritizing
prisd	prised
prisin	prising
prisin	prising
privatisd	privatised
privatisin	privatising
privatizd	privatized
privatizin	privatizing
privilegd	privileged
privilegin	privileging
privilegin	privileging
privtisin	privatising
privtizin	privatizing
prizd	prized
prizin	prizing
prizin	prizing
prjectin	projecting
prjudgin	prejudging
prjudicin	prejudicing
prlifer8in	proliferating
prlongin	prolonging
prmeatin	permeating
prmierin	premiering
prmisin	promising
prmitin	permitting
prmulg8in	promulgating
prnouncin	pronouncing
prnt	print
prntin	printing
prntmkin	printmaking
prnts	prints
pro	professional
pro2typ	prototype
problm	problem
probd	probed
probin	probing
probin	probing
probs	problems
proceedd	proceeded
proceedin	proceeding
procesin	processing
processd	processed
processin	processing
proclaimd	proclaimed
proclaimin	proclaiming
proclamin	proclaiming
procr8in	procreating
procrastin8d	procrastinated
procrastinatin	procrastinating
procreatd	procreated
procreatin	procreating
procupyin	preoccupying
procurd	procured
procurin	procuring
procurin	procuring
proddd	prodded
proddin	prodding
prodin	prodding
producd	produced
producin	producing
prof	professor
professd	professed
professin	professing
profferd	proffered
profferin	proffering
profild	profiled
profilin	profiling
profitd	profited
profiteerin	profiteering
profitin	profiting
profs	professors
programmd	programmed
programmin	programming
progressd	progressed
progressin	progressing
prohibitd	prohibited
prohibitin	prohibiting
projct	project
projectd	projected
projectin	projecting
prolifer8d	proliferated
proliferatin	proliferating
prolongd	prolonged
prolongin	prolonging
promisd	promised
promisin	promising
promotd	promoted
promotin	promoting
promotin	promoting
promptd	prompted
promptin	prompting
promptin	prompting
promulg8d	promulgated
promulgatin	promulgating
pronouncd	pronounced
pronouncin	pronouncing
proofin	proofing
proofin	proofing
propagatin	propagating
propellin	propelling
profesyin	prophesying
propin	propping
propitiatin	propitiating
proposd	proposed
proposin	proposing
propositionin	propositioning
propoundin	propounding
proppin	propping
proscutin	prosecuting
prosecutd	prosecuted
proselytisin	proselytising
proselytizin	proselytizing
prospectin	prospecting
prosperd	prospered
prosperin	prospering
prostitutd	prostituted
prostitutin	prostituting
prostr8d	prostrated
prostr8in	prostrating
prostratin	prostrating
protectd	protected
protectin	protecting
protestd	protested
protestin	protesting
protrudin	protruding
providin	providing
provin	proving
provin	proving
provisiond	provisioned
provisionin	provisioning
provokd	provoked
provokin	provoking
prowlin	prowling
prowlin	prowling
prpag8in	propagating
prparin	preparing
prpayin	prepaying
prpelin	propelling
prpetr8in	perpetrating
prpetu8in	perpetuating
prpiti8in	propitiating
prplexin	perplexing
prposin	proposing
prpositionin	propositioning
prpoundin	propounding
prsagin	presaging
prscribin	prescribing
prscutin	persecuting
prselytisin	proselytising
prselytizin	proselytizing
prseverin	persevering
prshin	pershing
prsistin	persisting
prsn	person
prsnalisin	personalising
prsnalizin	personalizing
prsnifyin	personifying
prson8in	personating
prspectin	prospecting
prsperin	prospering
prspirin	perspiring
prstitutin	prostituting
prsuadin	persuading
prsumin	presuming
prsuposin	presupposing
prsurisin	pressurising
prsurizin	pressurizing
prt	part
prtainin	pertaining
prtectin	protecting
prtendin	pretending
prtestin	protesting
prtrayin	portraying
prtrudin	protruding
prturbin	perturbing
prty	party
prtys	parties
prunin	pruning
prunin	pruning
prusin	perusing
prvadin	pervading
prvailin	prevailing
prvaric8in	prevaricating
prventin	preventing
prvertin	perverting
prvidin	providing
prvisionin	provisioning
prvntd	prevented
prvokin	provoking
pryin	prying
pryin	prying
ps	post script
psesin	possessing
psitionin	positioning
pssible	possible
pssiblty	possibility
pssmstic	pessimistic
pstd	posted
pstive	positive
pstul8in	postulating
publicisin	publicising
publicisin	publicising
publishin	publishing
publishin	publishing
publsh	publish
publshd	published
puckerin	puckering
puddin	pudding
puffin	puffing
pufin	puffing
pukerin	puckering
pukin	puking
pukin	puking
pulin	pulling
pullin	pulling
pulpin	pulping
pulpin	pulping
puls8in	pulsating
pulsatin	pulsating
pulsin	pulsing
pulsin	pulsing
pulverisd	pulverised
pulverisin	pulverising
pulverizd	pulverized
pulverizin	pulverizing
pulvrisin	pulverising
pulvrizin	pulverizing
pumelin	pummelling
pummelld	pummelled
pummellin	pummelling
pumpd	pumped
pumpin	pumping
pumpin	pumping
punchd	punched
punchin	punching
punchin	punching
punctu8d	punctuated
punctu8in	punctuating
punctuatin	punctuating
puncturd	punctured
puncturin	puncturing
puncturin	puncturing
punin	punning
punishd	punished
punishin	punishing
punishin	punishing
punnin	punning
puntin	punting
puntin	punting
pup8in	pupating
pupatin	pupating
purchasin	purchasing
purgin	purging
purifyin	purifying
purlin	purling
purling	purling
purportin	purporting
purportin	purporting
purps	purpose
purrin	purring
purrin	purring
pursin	pursing
pursin	pursing
pursuin	pursuing
pursuin	pursuing
purveyd	purveyed
purveyin	purveying
purveyin	purveying
pushd	pushed
pushin	pushing
pushin	pushing
pussyfootin	pussyfooting
pusyfootin	pussyfooting
putrefyin	putrefying
putrfyin	putrefying
putterin	puttering
putterin	puttering
puttin	putting
puttin	putting
puzlin	puzzling
puzzld	puzzled
puzzlin	puzzling
pwderin	powdering
pwring	powering
q	question
qarantind	quarantined
qs	questions
qstiond	questioned
quackin	quacking
quadruplin	quadrupling
quadruplin	quadrupling
quaffin	quaffing
quafin	quaffing
quakin	quaking
quakin	quaking
qualfctn	qualification
qualfctns	qualifications
qualifyin	qualifying
qualifyin	qualifying
quantifyin	quantifying
quantifyin	quantifying
quarantinin	quarantining
quarantinin	quarantining
quarelin	quarrelling
quarrellin	quarrelling
quarryin	quarrying
quarterin	quartering
quarterin	quartering
quaryin	quarrying
quashin	quashing
quashin	quashing
quaverin	quavering
quavrin	quavering
qud	queued
quelin	quelling
quellin	quelling
quenchin	quenching
quenchin	quenching
queryin	querying
queryin	querying
questin	questing
questin	questing
questionin	questioning
questionin	questioning
queuein	queueing
queuein	queueing
queuin	queuing
queuin	queuing
quibblin	quibbling
quiblin	quibbling
quickenin	quickening
quietenin	quietening
quietin	quieting
quietin	quieting
quietnin	quietening
quiknin	quickening
quiltin	quilting
quiltin	quilting
quintuplin	quintupling
quintuplin	quintupling
quislin	quisling
quislin	quisling
quitin	quitting
quittin	quitting
quiverd	quivered
quiverin	quivering
quivrin	quivering
quizin	quizzing
quizzd	quizzed
quizzin	quizzing
quotd	quoted
quotin	quoting
quotin	quoting
r	are
r8	rate
racin	racing
racin	racing
racketeerin	racketeering
rackin	racking
radi8in	radiating
radiatin	radiating
radioin	radioing
radioin	radioing
rafflin	raffling
raflin	raffling
raftin	rafting
raftin	rafting
ragin	raging
ragin	raging
raidin	raiding
raidin	raiding
railin	railing
railin	railing
railroadin	railroading
railrodin	railroading
raind	rained
rainin	raining
rainin	raining
raisd	raised
raisin	raising
raising	raising
rakin	racking
rakin	raking
raking	raking
rakterin	racketeering
rallyin	rallying
ralyin	rallying
ramblin	rambling
ramblin	rambling
ramin	ramming
rammin	ramming
rampagin	rampaging
rampagin	rampaging
ranchin	ranching
ranchin	ranching
randomisin	randomising
randomisin	randomising
randomizin	randomizing
randomizin	randomizing
rangin	ranging
rangin	ranging
rankin	ranking
rankin	ranking
ranklin	rankling
ranklin	rankling
ransackin	ransacking
ransakin	ransacking
ransomin	ransoming
ransomin	ransoming
rantin	ranting
rantin	ranting
rapelin	rappelling
rapin	raping
rapin	raping
rappellin	rappelling
rappin	rapping
rappin	rapping
rarin	raring
rarin	raring
raspin	rasping
raspin	rasping
ratifyin	ratifying
ratifyin	ratifying
ratin	rating
ratin	rating
rationalisd	rationalised
rationalisin	rationalising
rationalizd	rationalized
rationalizin	rationalizing
rationd	rationed
rationin	rationing
rationin	rationing
rationlisin	rationalising
rationlizin	rationalizing
ratlin	rattling
rattlin	rattling
ravagin	ravaging
ravelin	ravelling
ravellin	ravelling
ravenin	ravening
ravgin	ravaging
ravin	raving
raving	raving
ravishin	ravishing
ravishin	ravishing
ravnin	ravening
razin	razing
razin	razing
rcgnisd	recognised
rcgnise	recognise
rcgnizd	recognized
rcvd	received
rcvd	received
rding	reading
rdio	radio
re4md	reformed
re4ming	reforming
re4mul8d	reformulated
re4mul8in	reformulating
reachd	reached
reachin	reaching
reachin	reaching
reactd	reacted
reactin	reacting
reactin	reacting
reactiv8d	reactivated
reactiv8in	reactivating
reactivatin	reactivating
readin	reading
readin	reading
readjustin	readjusting
readjustin	readjusting
readr	reader
readrs	readers
readyin	readying
readyin	readying
reaffirmd	reaffirmed
reaffirmin	reaffirming
reafirmin	reaffirming
realignd	realigned
realignin	realigning
realignin	realigning
realisd	realised
realisin	realising
realisin	realising
realizd	realized
realizin	realizing
realizin	realizing
realloc8in	reallocating
reallocatin	reallocating
realy	really
reanim8in	reanimating
reanimatin	reanimating
reapearin	reappearing
reapin	reaping
reapin	reaping
reaplyin	reapplying
reappearin	reappearing
reapplyin	reapplying
reappraisd	reappraised
reappraisin	reappraising
reappraisin	reappraising
rearanging	rearranging
reard	reared
rearin	rearing
rearin	rearing
rearmin	rearming
rearming	rearming
rearrangd	rearranged
rearrangin	rearranging
reasemblin	reassembling
reasertin	reasserting
reasesin	reassessing
reasignin	reassigning
reasond	reasoned
reasonin	reasoning
reasonin	reasoning
reassembld	reassembled
reassertd	reasserted
reassessd	reassessed
reassignd	reassigned
reassurd	reassured
reasurin	reassuring
reauthorizin	reauthorizing
reauthorizin	reauthorizing
reawaknin	reawakening
rebelin	rebelling
rebellin	rebelling
rebildin	rebuilding
reboundin	rebounding
reboundin	rebounding
rebuffin	rebuffing
rebufin	rebuffing
rebuildin	rebuilding
rebukin	rebuking
rebukin	rebuking
rebutin	rebutting
rebuttin	rebutting
recalcul8d	recalculated
recalcul8in	recalculating
recalculatin	recalculating
recallin	recalling
recallin	recalling
recantin	recanting
recantin	recanting
recapin	recapping
recappin	recapping
recapturin	recapturing
recapturin	recapturing
recastin	recasting
recastin	recasting
recedin	receding
recedin	receding
receivin	receiving
recesin	recessing
recessd	recessed
recessin	recessing
recev	receive
recevin	receiving
recevin	receiving
recgnisin	recognising
recgnizin	recognizing
rechargd	recharged
rechargin	recharging
rechargin	recharging
recheckd	rechecked
recheckin	rechecking
rechekin	rechecking
reciproc8d	reciprocated
reciproc8in	reciprocating
reciprocatin	reciprocating
recitd	recited
recitin	reciting
recitin	reciting
reckond	reckoned
reckonin	reckoning
reclaimd	reclaimed
reclaimin	reclaiming
reclamin	reclaiming
reclind	reclined
reclinin	reclining
reclinin	reclining
recmnded	recommended
recognisin	recognising
recognizin	recognizing
recoild	recoiled
recoilin	recoiling
recoilin	recoiling
recolectd	recollected
recolectin	recollecting
recollectin	recollecting
recomencd	recommenced
recomencin	recommencing
recomendin	recommending
recommencin	recommencing
recommendin	recommending
reconcild	reconciled
reconcilin	reconciling
reconcilin	reconciling
reconditiond	reconditioned
reconditionin	reconditioning
reconditionin	reconditioning
reconnoitrd	reconnoitred
reconnoitrin	reconnoitring
reconoitrin	reconnoitring
reconsiderd	reconsidered
reconsiderin	reconsidering
reconsidrin	reconsidering
reconstitutd	reconstituted
reconstitutin	reconstituting
reconstitutin	reconstituting
reconstructd	reconstructed
reconstructin	reconstructing
reconstructin	reconstructing
reconvend	reconvened
reconvenin	reconvening
reconvenin	reconvening
recordd	recorded
recordin	recording
recordin	recording
recountd	recounted
recountin	recounting
recountin	recounting
recoupd	recouped
recoupin	recouping
recoupin	recouping
recoverin	recovering
recovrd	recovered
recovrin	recovering
recr8in	recreating
recreatd	recreated
recreatin	recreating
recruitd	recruited
recruitin	recruiting
recruitin	recruiting
rectifyin	rectifying
rectifyin	rectifying
recuperatin	recuperating
recupr8in	recuperating
recurin	recurring
recurrd	recurred
recurrin	recurring
recycld	recycled
recycld	recycled
recyclin	recycling
recyclin	recycling
reddenin	reddening
reddin	redding
reddin	redding
reddnin	reddening
redecor8d	redecorated
redecor8in	redecorating
redecoratin	redecorating
redeemd	redeemed
redeemin	redeeming
redeemin	redeeming
redefind	redefined
redefinin	redefining
redefinin	redefining
redeployd	redeployed
redeployin	redeploying
redeployin	redeploying
redesignd	redesigned
redesignin	redesigning
redesynin	redesigning
redevelopd	redeveloped
redevelopin	redeveloping
redevlopin	redeveloping
redirectd	redirected
redirectin	redirecting
redirectin	redirecting
rediscoverd	rediscovered
rediscoverin	rediscovering
rediscovrin	rediscovering
redistributd	redistributed
redistributin	redistributing
redistributin	redistributing
redistrictin	redistricting
redistrictin	redistricting
redlinin	redlining
redlinin	redlining
redoin	redoing
redoin	redoing
redoublin	redoubling
redoublin	redoubling
redraftin	redrafting
redraftin	redrafting
redrawin	redrawing
redrawin	redrawing
redresin	redressing
redressin	redressing
reducd	reduced
reducin	reducing
reducin	reducing
redy	ready
reefin	reefing
reefin	reefing
reekin	reeking
reekin	reeking
reelin	reeling
reelin	reeling
reestablishin	re-establishing
reestablishin	re-establishing
ref	reference
referd	referred
refereein	refereeing
referein	refereeing
referencd	referenced
referencin	referencing
referin	referring
referncin	referencing
referrin	referring
refild	refilled
refillin	refilling
refillin	refilling
refinancd	refinanced
refinancin	refinancing
refinancin	refinancing
refind	refined
refinin	refining
refinin	refining
refinishin	refinishing
refinishin	refinishing
refitin	refitting
refittd	refitted
refittin	refitting
reflectd	reflected
reflectin	reflecting
reflectin	reflecting
refocusd	refocused
refocusin	refocusing
refocusin	refocusing
refractd	refracted
refractin	refracting
refraind	refrained
refrainin	refraining
refrainin	refraining
refrazin	rephrasing
refreshd	refreshed
refreshin	refreshing
refreshin	refreshing
refuelin	refuelling
refuelld	refuelled
refuellin	refuelling
refundd	refunded
refundin	refunding
refundin	refunding
refurbishd	refurbished
refurbishin	refurbishing
refurbishin	refurbishing
refusd	refused
refusin	refusing
refusin	refusing
refutd	refuted
refutin	refuting
refutin	refuting
regaind	regained
regainin	regaining
regainin	regaining
regald	regaled
regalin	regaling
regalin	regaling
regardd	regarded
regardin	regarding
regardin	regarding
regener8d	regenerated
regener8in	regenerating
regeneratin	regenerating
registerd	registered
registerin	registering
registrin	registering
reglrly	regularly
regressd	regressed
regressin	regressing
regressin	regressing
regretin	regretting
regrettd	regretted
regrettin	regretting
regroupd	regrouped
regroupin	regrouping
regrupin	regrouping
regul8d	regulated
regul8in	regulating
regulatin	regulating
regurgit8d	regurgitated
regurgit8in	regurgitating
regurgitatin	regurgitating
rehabilit8d	rehabilitated
rehabilit8in	rehabilitating
rehabilitatin	rehabilitating
rehashd	rehashed
rehashin	rehashing
rehashin	rehashing
rehearin	rehearing
rehearin	rehearing
rehearsd	rehearsed
rehearsin	rehearsing
reheatd	reheated
reheatin	reheating
reheatin	reheating
rehersin	rehearsing
rehirin	rehiring
rehousd	rehoused
rehousin	rehousing
rehousin	rehousing
reignd	reigned
reignin	reigning
reignin	reigning
reignitd	reignited
reignitin	reigniting
reignitin	reigniting
reimbursd	reimbursed
reimbursin	reimbursing
reimbursin	reimbursing
rein4cd	reinforced
rein4cin	reinforcing
reincarn8in	reincarnating
reincarnatin	reincarnating
reincr8d	reincarnated
reinin	reining
reinin	reining
reinst8in	reinstating
reinstatd	reinstated
reinstatin	reinstating
reinterpretd	reinterpreted
reinterpretin	reinterpreting
reinterprtin	reinterpreting
reintrducin	reintroducing
reintroducd	reintroduced
reintroducin	reintroducing
reinventin	reinventing
reinvestd	reinvested
reinvestin	reinvesting
reinvigor8d	reinvigorated
reinvigoratin	reinvigorating
reinvigr8in	reinvigorating
reinvntin	reinventing
reissud	reissued
reissuin	reissuing
reissuin	reissuing
reiter8d	reiterated
reiter8in	reiterating
reiteratin	reiterating
rejectd	rejected
rejectin	rejecting
rejectin	rejecting
rejoicd	rejoiced
rejoicin	rejoicing
rejoicin	rejoicing
rejoind	rejoined
rejoinin	rejoining
rejoinin	rejoining
rejuven8d	rejuvenated
rejuvenatin	rejuvenating
rejuvn8in	rejuvenating
rekindld	rekindled
rekindlin	rekindling
rekindlin	rekindling
reknin	reckoning
rel8	relate
rel8d	related
rel8in	relating
relapsd	relapsed
relapsin	relapsing
relapsin	relapsing
relatin	relating
relaxd	relaxed
relaxin	relaxing
relaxin	relaxing
relayd	relayed
relayin	relaying
relayin	relaying
relearnin	relearning
relearnin	relearning
releasd	released
releasin	releasing
releasin	releasing
releg8d	relegated
releg8in	relegating
relegatin	relegating
relentd	relented
relentin	relenting
relentin	relenting
relievd	relieved
relievin	relieving
relievin	relieving
relinquishd	relinquished
relinquishin	relinquishing
relinquishin	relinquishing
relishd	relished
relishin	relishing
relishin	relishing
relivd	relived
relivin	reliving
relivn	reliving
reloadin	reloading
reloc8d	relocated
reloc8in	relocating
relocatin	relocating
relyin	relying
relyin	relying
remaind	remained
remainderd	remaindered
remainderin	remaindering
remainin	remaining
remainin	remaining
remakin	remaking
remakin	remaking
remanufacturin	remanufacturing
remarkd	remarked
remarkin	remarking
remarkin	remarking
remasterd	remastered
remasterin	remastering
remedyin	remedying
remedyin	remedying
rememberin	remembering
remembrin	remembering
remindin	reminding
remindin	reminding
reminiscd	reminisced
reminiscin	reminiscing
reminisin	reminiscing
remitd	remitted
remitin	remitting
remittin	remitting
remmbr	remember
remmbrd	remembered
remodeld	remodelled
remodelin	remodelling
remonstr8d	remonstrated
remonstr8in	remonstrating
removd	removed
removn	removing
renamd	renamed
renamin	renaming
renderd	rendered
renderin	rendering
renegd	reneged
renegin	reneging
renegin	reneging
renegoti8d	renegotiated
renegoti8in	renegotiating
renewd	renewed
renewin	renewing
renewin	renewing
renouncd	renounced
renouncin	renouncing
renouncin	renouncing
renov8d	renovated
renov8in	renovating
renovatin	renovating
rentd	rented
rentin	renting
rentin	renting
reopend	reopened
reopenin	reopening
reopenin	reopening
reorderd	reordered
reorderin	reordering
reorderin	reordering
reorganisd	reorganised
reorganisin	reorganising
reorganizd	reorganized
reorganizin	reorganizing
reorgnisin	reorganising
reorgnizin	reorganizing
reothorizd	reauthorized
repackagd	repackaged
repackagin	repackaging
repackin	repacking
repaintd	repainted
repaintin	repainting
repaintin	repainting
repaird	repaired
repairin	repairing
repairin	repairing
repakin	repacking
repatri8d	repatriated
repatri8in	repatriating
repatriatin	repatriating
repavin	repaving
repavin	repaving
repayin	repaying
repayin	repaying
repeald	repealed
repealin	repealing
repealin	repealing
repeatd	repeated
repeatin	repeating
repeatin	repeating
repelin	repelling
repelld	repelled
repellin	repelling
repentd	repented
repentin	repenting
repentin	repenting
refrasd	rephrased
refrasin	rephrasing
repkging	repackaging
replacd	replaced
replacin	replacing
replantd	replanted
replantin	replanting
replayd	replayed
replayin	replaying
replayin	replaying
replenishd	replenished
replenishin	replenishing
replenishin	replenishing
replic8d	replicated
replic8in	replicating
replicatin	replicating
replyin	replying
replyin	replying
reportd	reported
reportin	reporting
reportin	reporting
reposd	reposed
reposesd	repossessed
reposesin	repossessing
reposin	reposing
reposin	reposing
repositioned	repositioned
repositionin	repositioning
repossessin	repossessing
reprchasin	repurchasing
reprdusin	reproducing
representin	representing
represin	repressing
represntin	representing
repressin	repressing
reprimandin	reprimanding
reprimandin	reprimanding
reprintin	reprinting
reprntin	reprinting
reproachin	reproaching
reprocesin	reprocessing
reprocessin	reprocessing
reprochin	reproaching
reproducd	reproduced
reproducin	reproducing
reprogramin	reprogramming
reprogrammin	reprogramming
reprovin	reproving
reprovin	reproving
reps	representatives
repsitionin	repositioning
repudi8in	repudiating
repudiatin	repudiating
repulsin	repulsing
repulsin	repulsing
repurchasin	repurchasing
requestd	requested
requestin	requesting
requestin	requesting
requirin	requiring
requirin	requiring
requisitionin	requisitioning
requisitionin	requisitioning
reroutin	rerouting
reroutin	rerouting
rerunin	rerunning
rerunnin	rerunning
rescheduld	rescheduled
reschedulin	rescheduling
rescindin	rescinding
rescuin	rescuing
rescuin	rescuing
resdnce	residence
researchd	researched
researchin	researching
reselin	reselling
resellin	reselling
resembld	resembled
resemblin	resembling
resemblin	resembling
resentd	resented
resentin	resenting
reservd	reserved
reservin	reserving
resetin	resetting
resetlin	resettling
resettin	resetting
resettld	resettled
resettlin	resettling
reshapd	reshaped
reshapin	reshaping
reshapin	reshaping
reshuffld	reshuffled
reshufflin	reshuffling
reshuflin	reshuffling
residin	residing
residin	residing
resignd	resigned
resignin	resigning
resignin	resigning
resindin	rescinding
resistd	resisted
resistin	resisting
resistin	resisting
reskedulin	rescheduling
resntin	resenting
resolvd	resolved
resolvin	resolving
resolvin	resolving
reson8d	resonated
reson8in	resonating
resonatin	resonating
resortd	resorted
resortin	resorting
resortin	resorting
resoundin	resounding
resoundin	resounding
resourcd	resourced
resourcin	resourcing
resourcin	resourcing
respectd	respected
respectin	respecting
respectin	respecting
respondin	responding
respondin	responding
resrchin	researching
resrvin	reserving
rest8d	restated
rest8in	restating
restartd	restarted
restartin	restarting
restartin	restarting
restatin	restating
restin	resting
restin	resting
restockin	restocking
restokin	restocking
restord	restored
restorin	restoring
restorin	restoring
restraind	restrained
restrainin	restraining
restrainin	restraining
restrictd	restricted
restrictin	restricting
restrictin	restricting
restructurd	restructured
restructurin	restructuring
restructurin	restructuring
resultd	resulted
resultin	resulting
resultin	resulting
resumd	resumed
resumin	resuming
resumin	resuming
resurectin	resurrecting
resurfacd	resurfaced
resurfacin	resurfacing
resurfacin	resurfacing
resurrectd	resurrected
resurrectin	resurrecting
resuscit8d	resuscitated
resuscit8in	resuscitating
resuscitatin	resuscitating
retaild	retailed
retailin	retailing
retailin	retailing
retaind	retained
retainin	retaining
retainin	retaining
retakin	retaking
retakin	retaking
retali8in	retaliating
retaliatin	retaliating
retardin	retarding
retardin	retarding
retchin	retching
retchin	retching
retelin	retelling
retellin	retelling
retestin	retesting
retestin	retesting
rethinkin	rethinking
rethinkin	rethinking
retirin	retiring
retirin	retiring
retoolin	retooling
retoolin	retooling
retortin	retorting
retortin	retorting
retouchin	retouching
retouchin	retouching
retracin	retracing
retracin	retracing
retractin	retracting
retractin	retracting
retraind	retrained
retrainin	retraining
retrainin	retraining
retreadin	retreading
retreadin	retreading
retreatd	retreated
retreatin	retreating
retreatin	retreating
retrenchd	retrenched
retrenchin	retrenching
retrenchin	retrenching
retrievd	retrieved
retrievin	retrieving
retrievin	retrieving
retrofitin	retrofitting
retrofittin	retrofitting
retryin	retrying
retryin	retrying
returnd	returned
returnin	returning
returnin	returning
reunifyin	reunifying
reunifyin	reunifying
reunitd	reunited
reunitin	reuniting
reunitin	reuniting
reusd	reused
reusin	reusing
reusin	reusing
revampd	revamped
revampin	revamping
revampin	revamping
reveald	revealed
revealin	revealing
revealin	revealing
revelin	revelling
revelled	revelled
revellin	revelling
revengd	revenged
revengin	revenging
revengin	revenging
reverberatd	reverberated
reverberatin	reverberating
reverd	revered
reverin	revering
reverin	revering
reversd	reversed
reversin	reversing
revertd	reverted
revertin	reverting
reviewd	reviewed
reviewin	reviewing
reviewin	reviewing
revild	reviled
revilin	reviling
revilin	reviling
revisd	revised
revisin	revising
revisin	revising
revisitd	revisited
revisitin	revisiting
revisitin	revisiting
revitalisin	revitalising
revitalizin	revitalizing
revitlisin	revitalising
revitlizin	revitalizing
revivfyin	revivifying
revivifyin	revivifying
revivin	reviving
revivin	reviving
revokin	revoking
revokin	revoking
revoltin	revolting
revoltin	revolting
revolutionisin	revolutionising
revolutionisin	revolutionising
revolvin	revolving
revolvin	revolving
revrbr8in	reverberating
revrsin	reversing
revrtin	reverting
revuw	review
revvin	revving
revvin	revving
rewardin	rewarding
rewardin	rewarding
rewindin	rewinding
rewindin	rewinding
rewirin	rewiring
rewirin	rewiring
rewordin	rewording
rewordin	rewording
reworkin	reworking
rewritin	rewriting
rewritin	rewriting
rewrkin	reworking
rflct	reflect
rflcts	reflects
rghtin	righting
rhymd	rhymed
rhymin	rhyming
ribbin	ribbing
ribin	ribbing
rickin	ricking
ricochetin	ricocheting
ricochetin	ricocheting
ridclus	ridiculous
riddin	ridding
riddin	ridding
riddlin	riddling
ridiculin	ridiculing
ridiculin	ridiculing
ridin	riding
ridin	riding
ridlin	riddling
rieslin	riesling
rieslin	riesling
riflin	rifling
riflin	rifling
riggin	rigging
rightin	righting
rigin	rigging
rikin	ricking
rilin	riling
rilin	riling
ringin	ringing
rinin	ringing
rinsin	rinsing
rinsin	rinsing
riotd	rioted
riotin	rioting
riotin	rioting
ripend	ripened
ripenin	ripening
ripin	ripping
riplin	rippling
ripnin	ripening
rippd	ripped
rippin	ripping
rippld	rippled
ripplin	rippling
riproarin	rip-roaring
riproarin	rip-roaring
risin	rising
risin	rising
riskd	risked
riskin	risking
riskin	risking
rite	right
rite	right
rites	rights
rivald	rivalled
rivalin	rivalling
rivallin	rivalling
rivetd	riveted
rivetin	riveting
rivtin	riveting
rltnshp	relationship
rmain	remain
rmains	remains
rminded	reminded
roamd	roamed
roamin	roaming
roamin	roaming
roard	roared
roarin	roaring
roarin	roaring
roastd	roasted
roastin	roasting
robbin	robbing
robbin	robbing
robd	robbed
rockd	rocked
rocketd	rocketed
rocketin	rocketing
rockin	rocking
rodin	roding
rodin	roding
roisterin	roistering
roisterin	roistering
rok	rock
rokin	rocking
roktin	rocketing
rolikin	rollicking
rolin	rolling
rolld	rolled
rollickin	rollicking
rollin	rolling
romancin	romancing
romancin	romancing
romanticisd	romanticised
romanticisin	romanticising
romanticisin	romanticising
romanticized	romanticized
romanticizin	romanticizing
romanticizin	romanticizing
rompd	romped
rompin	romping
rompin	romping
roofd	roofed
roofin	roofing
roofin	roofing
roomin	rooming
roomin	rooming
roostd	roosted
roostin	roosting
roostin	roosting
rootd	rooted
rootin	rooting
rootin	rooting
ropin	roping
ropin	roping
rostin	roasting
rot8	rotate
rot8d	rotated
rot8in	rotating
rottd	rotted
rottin	rotting
rottin	rotting
roughd	roughed
roughin	roughing
roughin	roughing
roundd	rounded
roundin	rounding
roundin	rounding
rousd	roused
rousin	rousing
rousin	rousing
routed	routed
routin	routing
routin	routing
roved	roved
rovin	roving
rovin	roving
rowed	rowed
rowin	rowing
rowin	rowing
rox	rocks
rprsntd	represented
rqst	request
rqsts	requests
rsk	risk
rspnsblty	responsibility
rsrch	research
rst	rest
rsults	results
rtcl	article
rtrn	return
rubbd	rubbed
rubbin	rubbing
rubbin	rubbing
rubbishd	rubbished
rubbishin	rubbishing
rubishin	rubbishing
ruffld	ruffled
rufflin	ruffling
ruflin	ruffling
ruind	ruined
ruinin	ruining
ruinin	ruining
ruld	ruled
rulin	ruling
rulin	ruling
rumagin	rummaging
rumbld	rumbled
rumblin	rumbling
rumblin	rumbling
rumin8d	ruminated
rumin8in	ruminating
ruminatin	ruminating
rummagd	rummaged
rummagin	rummaging
runin	running
runin	running
runnin	running
rupturd	ruptured
rupturin	rupturing
rupturin	rupturing
rushd	rushed
rushin	rushing
rushin	rushing
rustd	rusted
rustin	rusting
rustin	rusting
rustld	rustled
rustlin	rustling
rustlin	rustling
rview	review
rviews	reviews
rvnu	revenue
rymin	rhyming
s	is
sabotagd	sabotaged
sabotagin	sabotaging
sackin	sacking
sacrificin	sacrificing
sacrifsd	sacrificed
saddenin	saddening
saddlin	saddling
sadld	saddled
sadnd	saddened
safeguardin	safeguarding
safekeepin	safekeeping
safguardd	safeguarded
sagd	sagged
saggin	sagging
saild	sailed
sailin	sailing
sakd	sacked
salivatin	salivating
sallyin	sallying
salutd	saluted
salutin	saluting
salvagd	salvaged
salvagin	salvaging
salvd	salved
salvin	salving
sampld	sampled
samplin	sampling
sanctiond	sanctioned
sanctionin	sanctioning
sandbagd	sandbagged
sandbaggin	sandbagging
sanded	sanded
sandin	sanding
sandlin	sandling
sandpaperin	sandpapering
sandwichin	sandwiching
sanwichd	sandwiched
sapd	sapped
saplin	sapling
sappin	sapping
saturdy	Saturday
satirisin	satirising
satirizd	satirised
satisfyin	satisfying
satur8d	saturated
saturatin	saturating
saunterin	sauntering
sauntrd	sauntered
savagin	savaging
savd	saved
savgd	savaged
savin	saving
savourd	savoured
savourin	savouring
sawd	sawed
sawin	sawing
sayin	saying
sbdividd	subdivided
sbjctd	subjected
sbjug8d	subjugated
sbmitd	submitted
sbmrgd	submerged
sbpoenad	subpoenaed
sbrdin8d	subordinated
sbscrbd	subscribed
sbsidd	subsided
sbsidisd	subsidised
sbsidizd	subsidized
sbsistd	subsisted
sbstanti8d	substantiated
sbstitutd	substituted
sbtitld	subtitled
sbtndd	subtended
sbtrakd	subtracted
sbvrtd	subverted
scafoldin	scaffolding
scaldd	scalded
scaldin	scalding
scaled	scaled
scaling	scaling
scalpd	scalped
scalpin	scalping
scamperd	scampered
scamperin	scampering
scand	scanned
scannin	scanning
scared	scared
scaremongerin	scaremongering
scarifyin	scarifying
scarin	scaring
scarred	scarred
scarrin	scarring
scaterd	scattered
scathin	scathing
scatterin	scattering
scavengd	scavenged
scavengin	scavenging
scceedd	succeeded
sccumbd	succumbed
scentd	scented
scentin	scenting
schedulin	scheduling
schemin	scheming
schillin	schilling
schmoozin	schmoozing
sci	science
scintil8d	scintillated
scintillatin	scintillating
sck	sick
scnding	seconding
scofd	scoffed
scofin	scoffing
scoldd	scolded
scoldin	scolding
scorchd	scorched
scorchin	scorching
scored	scored
scorin	scoring
scornd	scorned
scornin	scorning
scourgd	scourged
scourgin	scourging
scourin	scouring
scoutd	scouted
scoutin	scouting
scowld	scowled
scowlin	scowling
scrabblin	scrabbling
scrabld	scrabbled
scrambld	scrambled
scramblin	scrambling
scrapd	scraped
scrapin	scraping
scrappd	scrapped
scrappin	scrapping
scratchd	scratched
scratchin	scratching
scrawld	scrawled
scrawlin	scrawling
screamd	screamed
screamin	screaming
screechd	screeched
screechin	screeching
screend	screened
screenin	screening
screenwritin	screenwriting
screwd	screwed
screwin	screwing
scribblin	scribbling
scribld	scribbled
scrimpd	scrimped
scrimpin	scrimping
scriptd	scripted
scriptin	scripting
scrold	scrolled
scrollin	scrolling
scroungd	scrounged
scroungin	scrounging
scrtinysd	scrutinised
scrubbin	scrubbing
scrubd	scrubbed
scrummagin	scrummaging
scrutinisin	scrutinising
scrutinizin	scrutinizing
scudd	scudded
scuddin	scudding
scufd	scuffed
scuffin	scuffing
scufflin	scuffling
scufld	scuffled
sculld	sculled
scullin	sculling
sculptd	sculpted
sculptin	sculpting
scupd	scooped
scure	secure
scurryin	scurrying
scuttld	scuttled
scuttlin	scuttling
scythd	scythed
scythin	scything
sducd	seduced
seafarin	seafaring
seagoin	seagoing
seald	sealed
sealin	sealing
searchin	searching
seared	seared
searin	searing
seasnd	seasoned
seasonin	seasoning
seatd	seated
seatin	seating
sec	second
seceded	seceded
secedin	seceding
secretd	secreted
secretin	secreting
sectioni	sectioning
sectnd	sectioned
secured	secured
securin	securing
sed	said
seducin	seducing
seedd	seeded
seedin	seeding
seedlin	seedling
seein	seeing
seekin	seeking
seemd	seemed
seemin	seeming
seepin	seeping
seesawin	seesawing
seethin	seething
segmentin	segmenting
segmntd	segmented
segregatin	segregating
seizin	seizing
selectin	selecting
selekd	selected
selfgovernin	self-governing
sellin	selling
semiconductin	semiconducting
sendin	sending
sendin	sending
sensd	sensed
sensin	sensing
sentencin	sentencing
separatin	separating
sepr8d	separated
sept	september
sequencin	sequencing
serenadin	serenading
serialisd	serialised
serialisin	serialising
serializd	serialized
serializin	serializing
servd	served
servicin	servicing
servin	serving
sethd	seethed
setld	settled
settin	setting
settlin	settling
severd	severed
severin	severing
sewd	sewed
sewin	sewing
sexin	sexing
sfx	sound effects
sggst	suggest
sgnture	signature
sgreg8d	segregated
shaded	shaded
shadin	shading
shadod	shadowed
shadowin	shadowing
shaftin	shafting
shakin	shaking
shambld	shambled
shamblin	shambling
shamd	shamed
shamin	shaming
shammd	shammed
shammin	shamming
shampooin	shampooing
shampud	shampooed
shapd	shaped
shapin	shaping
shard	shared
shareholdin	shareholding
sharin	sharing
sharkin	sharking
sharpenin	sharpening
sharpnd	sharpened
shatrd	shattered
shatterin	shattering
shavd	shaved
shavin	shaving
sheard	sheared
shearin	shearing
sheathd	sheathed
sheathin	sheathing
sheddin	shedding
sheetin	sheeting
she'll	she will
shelld	shelled
shellin	shelling
shelterin	sheltering
sheltrd	sheltered
shelvd	shelved
shelvin	shelving
shepherdin	shepherding
shieldd	shielded
shieldin	shielding
shiftd	shifted
shiftin	shifting
shillin	shilling
shimmerin	shimmering
shimrd	shimmered
shind	shined
shinin	shining
shinnd	shinned
shinnin	shinning
shipbuildin	shipbuilding
shipd	shipped
shippin	shipping
shirkd	shirked
shirkin	shirking
shiverin	shivering
shivrd	shivered
shocasd	showcased
shockin	shocking
shoein	shoeing
shoestrin	shoestring
shokd	shocked
sholdrd	shouldered
shooed	shooed
shooin	shooing
shootin	shooting
shopd	shopped
shoplftd	shoplifted
shopliftin	shoplifting
shopn	shopping
shoppin	shopping
shord	shored
shorin	shoring
shortcomin	shortcoming
shortenin	shortening
shortin	shorting
shortnd	shortened
shoulderin	shouldering
shoutd	shouted
shoutin	shouting
shovd	shoved
shovellin	shovelling
shovin	shoving
shovld	shovelled
showcasin	showcasing
showd	showed
showerin	showering
showrd	showered
shphrd	shepherded
shpmnt	shipment
shpmnts	shipments
shps	shops
shredd	shredded
shreddin	shredding
shrekd	shrieked
shriekin	shrieking
shrimpin	shrimping
shrinkin	shrinking
shrivellin	shrivelling
shrivld	shrivelled
shroudd	shrouded
shroudin	shrouding
shrugd	shrugged
shruggin	shrugging
shtup	shut up
shuckin	shucking
shud	should
shudderin	shuddering
shuddrd	shuddered
shudnt	should not
shufflin	shuffling
shufld	shuffled
shunnd	shunned
shunnin	shunning
shuntd	shunted
shuntin	shunting
shutld	shuttled
shutrd	shuttered
shutterin	shuttering
shuttin	shutting
shuttlin	shuttling
shw	show
shwin	showing
shyin	shying
siblin	sibling
sickenin	sickening
sided	sided
sidesteppin	sidestepping
sidetrackin	sidetracking
sidin	siding
sidld	sidled
sidlin	sidling
sidstepd	sidestepped
sidtrakd	sidetracked
sievd	sieved
sievin	sieving
siftd	sifted
siftin	sifting
sighd	sighed
sighin	sighing
sightin	sighting
sightseein	sightseeing
signald	signalled
signallin	signalling
signifyin	signifying
signin	signing
signpostin	signposting
sikend	sickened
silencd	silenced
silencin	silencing
siltd	silted
siltin	silting
silverin	silvering
silvrd	silvered
simmerin	simmering
simmrd	simmered
simperin	simpering
simpl	simple
simplifyin	simplifying
simprd	simpered
simul8d	simulated
simulatin	simulating
singein	singeing
singlin	singling
sinkin	sinking
sinnd	sinned
sinnin	sinning
sipd	sipped
siphonin	siphoning
sippin	sipping
sis	sister
sitin	siting
sittin	sitting
situ8d	situated
situatin	situating
sizd	sized
sizin	sizing
sizld	sizzled
sizzlin	sizzling
sk8	skate
sk8	skate
sk8boardin	skateboarding
sk8d	skated
sk8er	skater
sk8in	skating
skeduld	scheduled
skemed	schemed
sketchd	sketched
sketchin	sketching
skidd	skidded
skiddin	skidding
skiin	skiing
skimd	skimmed
skimin	skimming
skimpd	skimped
skimpin	skimping
skind	skinned
skinin	skinning
skipd	skipped
skipperin	skippering
skippin	skipping
skiprd	skippered
skirmishin	skirmishing
skirtin	skirting
skool	school
skrmishd	skirmished
skrtd	skirted
skuled	schooled
skulin	schooling
skulkd	skulked
skulkin	skulking
skupin	scooping
skutin	scooting
skyd	skied
skydivin	skydiving
skyrketd	skyrocketed
skyrocketin	skyrocketing
sl8d	slated
slackd	slacked
slackenin	slackening
slackin	slacking
slagin	slagging
slaknd	slackened
slamd	slammed
slamin	slamming
slanderin	slandering
slandrd	slandered
slantd	slanted
slantin	slanting
slapd	slapped
slappin	slapping
slashd	slashed
slashin	slashing
slatin	slating
slaughterin	slaughtering
slavd	slaved
slaverin	slavering
slavin	slaving
slavrd	slavered
slayin	slaying
sleddin	sledding
sledgin	sledging
sleepin	sleeping
sleepwalkin	sleepwalking
sleuthin	sleuthing
slewd	slewed
slewin	slewing
slg	slag
slicd	sliced
slicin	slicing
slidin	sliding
slightin	slighting
slimd	slimmed
slimin	slimming
slingin	slinging
slinkin	slinking
slipd	slipped
slippin	slipping
slitherd	slithered
slitherin	slithering
slittin	slitting
slobberin	slobbering
sloganeerin	sloganeering
slogd	slogged
sloggin	slogging
slopd	slopped
sloped	sloped
slopin	sloping
sloppin	slopping
slorterd	slaughtered
sloshd	sloshed
sloshin	sloshing
slotd	slotted
slotting	slotting
slouchd	slouched
slouchin	slouching
sloughd	sloughed
sloughin	sloughing
slowd	slowed
slowin	slowing
slrpd	slurped
slugd	slugged
sluggin	slugging
sluicin	sluicing
sluisd	sluiced
slumberin	slumbering
slumbrd	slumbered
slumin	slumming
slumpd	slumped
slumpin	slumping
slurd	slurred
slurpin	slurping
slurrin	slurring
slytd	slighted
smackin	smacking
smakd	smacked
smallholdin	smallholding
smartd	smarted
smartenin	smartening
smartin	smarting
smartnd	smartened
smashd	smashed
smashin	smashing
smaterin	smattering
smeard	smeared
smearin	smearing
smeld	smelled
smellin	smelling
smeltd	smelted
smeltin	smelting
smiled	smiled
smilin	smiling
smirkin	smirking
smitin	smiting
smmr	summer
smokd	smoked
smokin	smoking
smoothin	smoothing
smotherin	smothering
smothrd	smothered
smoulderin	smouldering
smouldrd	smouldered
smrkd	smirked
smugglin	smuggling
smugld	smuggled
smuthd	smoothed
snackin	snacking
snagd	snagged
snaggin	snagging
snakd	snaked
snakin	snaking
snapd	snapped
snappin	snapping
snared	snared
snarin	snaring
snarld	snarled
snarlin	snarling
snatchd	snatched
snatchin	snatching
snd	send
sndy	Sunday
sneakd	sneaked
sneakin	sneaking
sneerd	sneered
sneerin	sneering
sneezin	sneezing
snellin	snelling
snezd	sneezed
sng	sing
sngin	singing
snickerin	snickering
snifd	sniffed
sniffin	sniffing
snifflin	sniffling
sniggerin	sniggering
snigrd	sniggered
snipd	snipped
snipin	sniping
snippin	snipping
snivellin	snivelling
sno	snow
snobald	snowballed
snoopin	snooping
snoozin	snoozing
snord	snored
snorin	snoring
snorkellin	snorkelling
snortd	snorted
snortin	snorting
snowballin	snowballing
snowboardin	snowboarding
snowd	snowed
snowin	snowing
snowmobilin	snowmobiling
sntensd	sentenced
snubbin	snubbing
snubd	snubbed
snufd	snuffed
snuffin	snuffing
snufflin	snuffling
snufld	snuffled
snugglin	snuggling
snugld	snuggled
snuzd	snoozed
snypd	sniped
soakin	soaking
soapd	soaped
soapin	soaping
soarin	soaring
sobbin	sobbing
sobd	sobbed
soberin	sobering
sobrd	sobered
socialisin	socialising
socializin	socializing
socialysd	socialised
socialyzd	socialized
sodomisin	sodomising
sodomizin	sodomizing
sodomysd	sodomised
softenin	softening
softnd	softened
soild	soiled
soilin	soiling
sojournd	sojourned
sojournin	sojourning
sokd	soaked
solderd	soldered
solderin	soldering
soldierd	soldiered
soldierin	soldiering
solicitd	solicited
solicitin	soliciting
solidifyin	solidifying
solin	soling
solvd	solved
solvin	solving
somersaultin	somersaulting
somrsoltd	somersaulted
songwritin	songwriting
soothd	soothed
soothin	soothing
soppin	sopping
sord	soared
sorrowin	sorrowing
sorrwd	sorrowed
sorsd	sourced
sorta	sort of
sorted	sorted
sortin	sorting
soundd	sounded
soundin	sounding
soundprfd	soundproofed
soundproofin	soundproofing
sourcin	sourcing
soured	scoured
sourd	soured
sourin	souring
southrn	southern
sowd	sowed
sowin	sowing
spacd	spaced
spacewalkin	spacewalking
spacin	spacing
spaldin	spalding
spand	spanned
spankd	spanked
spankin	spanking
spannin	spanning
spared	spared
sparin	sparing
sparkd	sparked
sparkin	sparking
sparkld	sparkled
sparklin	sparkling
sparrd	sparred
sparrin	sparring
spatrd	spattered
spatterin	spattering
spauldin	spaulding
spawnin	spawning
speakin	speaking
speard	speared
spearheadin	spearheading
spearhedd	spearheaded
spearin	spearing
specialisin	specialising
specializin	specializing
specifyin	specifying
speclysd	specialised
speclyzd	specialized
specul8d	speculated
speculatin	speculating
speechifyin	speechifying
speechmakin	speechmaking
speedd	speeded
speedin	speeding
speld	spelled
spellbindin	spellbinding
spellin	spelling
spendin	spending
spewin	spewing
spicin	spicing
spikd	spiked
spikin	spiking
spild	spilled
spillin	spilling
spinnin	spinning
spirald	spiralled
spirallin	spiralling
spisd	spiced
spittin	spitting
spk	speak
spkin	speaking
splashin	splashing
splatrd	splattered
splatterin	splattering
splayd	splayed
splintrd	splintered
splisd	spliced
splshd	splashed
splutrd	spluttered
spnd	spend
spndin	spending
spnt	spent
spoild	spoiled
spok	spoke
spongd	sponged
sponsrd	sponsored
spookd	spooked
spoond	spooned
sportd	sported
sposed	supposed
spotd	spotted
spotlytd	spotlighted
spoutd	spouted
spraind	sprained
sprawld	sprawled
sprayd	sprayed
spressd	suppressed
sprintd	sprinted
sprnkld	sprinkled
sproutd	sprouted
sprusd	spruced
spurnd	spurned
spurrd	spurred
spurtd	spurted
sputtrd	sputtered
spwd	spewed
spwnd	spawned
sqawkd	squawked
sqelchd	squelched
squabld	squabbled
squard	squared
squatd	squatted
squeakd	squeaked
squeald	squealed
squezd	squeezed
squintd	squinted
squnderd	squandered
squrmd	squirmed
squrtd	squirted
squshd	squashed
srch	search
srchd	searched
srenadd	serenaded
srfaced	surfaced
srfd	surfed
srgd	surged
srmised	surmised
srmountd	surmounted
srpasd	surpassed
srprisd	surprised
srrendrd	surrendered
srroundd	surrounded
srroundin	surrounding
srt	sort
srveyd	surveyed
srvisd	serviced
srvivd	survived
sry	sorry
st	street
st8	state
st8d	stated
st8iond	stationed
st8s	states
stabd	stabbed
stabld	stabled
stablyzd	stabilised
stackd	stacked
staffd	staffed
stagd	staged
stagn8d	stagnated
stagrd	staggered
staind	stained
stakd	staked
stalkd	stalked
stalld	stalled
stampd	stamped
stampedd	stampeded
stapld	stapled
stard	starred
stared	stared
startd	started
starvd	starved
stashd	stashed
staunchd	staunched
stavd	staved
stayd	stayed
stckd	stocked
stckpyld	stockpiled
stdnt	student
stdnts	students
stdy	study
stdyin	studying
steamd	steamed
steeld	steeled
steepd	steeped
steepnd	steepened
steerd	steered
stemmd	stemmed
stepd	stepped
stereotypd	stereotyped
sterilysd	sterilised
sterilyzd	sterilized
stewd	stewed
sthg	something
stifld	stifled
stifnd	stiffened
stigmatysd	stigmatised
stil	still
stild	stilled
stimul8d	stimulated
stipul8d	stipulated
stirrd	stirred
stitchd	stitched
stndrd	standard
stndrds	standards
stndrdysd	standardised
stndrdyzd	standardized
stokd	stoked
stompd	stomped
stoned	stoned
stonwald	stonewalled
stoopd	stooped
stopd	stopped
stord	stored
stormd	stormed
stowed	stowed
stp	stop
stpped	stopped
str8	straight
str8end	straightened
stra	stray
stradld	straddled
strafd	strafed
stragld	straggled
straind	strained
strandd	stranded
strapd	strapped
strayd	strayed
strctr	structure
strctrs	structures
streakd	streaked
streamlynd	streamlined
stremd	streamed
strenghnd	strengthened
stresd	stressed
strewd	strewed
strght4wrd	straightforward
strippd	stripped
strng	strong
strngld	strangled
strokd	stroked
strold	strolled
strt	start
strtchd	stretched
strted	started
strtin	starting
strtld	startled
structrd	structured
strugld	struggled
strumd	strummed
strutd	strutted
stry	story
stryvd	strived
stubd	stubbed
stubld	stumbled
stuf	stuff
stufd	stuffed
stuk	stuck
stumpd	stumped
stunnd	stunned
stuntd	stunted
stupfyd	stupefied
styld	styled
subcntrctd	subcontracted
subdud	subdued
subsumd	subsumed
suficd	sufficed
sufoc8d	suffocated
sufrd	suffered
sufusd	suffused
suggstd	suggested
sugrd	sugared
suitd	suited
sukd	sucked
sukld	suckled
sulkd	sulked
sullyd	sullied
sum	some
sum1	someone
sumday	someday
summd	summed
summond	summoned
summonsd	summonsed
sumrysd	summarised
sumryzd	summarized
sumtimes	sometimes
sunbathd	sunbathed
sunned	sunned
sup	what's up
supa	super
supacomputd	super computed
supaconductd	super conducted
supaimposd	superimposed
supersedd	superseded
suplemntd	supplemented
supped	supped
supplantd	supplanted
supplyd	supplied
suprtd	supported
suprvisd	supervised
sur	sure
surchrgd	surcharged
surprisin	surprising
suspectd	suspected
suspendd	suspended
sustaind	sustained
suxes	success
suxesful	successful
swabd	swabbed
swadld	swaddled
swagrd	swaggered
swalod	swallowed
swampd	swamped
swapd	swapped
swarmd	swarmed
swatd	swatted
swayd	swayed
sweetnd	sweetened
sweltrd	sweltered
swervd	swerved
swetd	sweated
swild	swilled
swindld	swindled
swirld	swirled
swishd	swished
swiveld	swivelled
swnd	sound
swnds	sounds
swoond	swooned
swoopd	swooped
swopd	swopped
swotcjd	switched
swt	sweet
sx	sex
sxe	sexy
syfond	siphoned
symbn	symbian
symbolisd	symbolised
symbolizd	symbolized
sympathisd	sympathised
sympathizd	sympathized
syncd	synchronized
syncronisd	synchronised
synthesisd	synthesised
synthesizd	synthesized
sys	system
sytd	sighted
tabled	tabled
tabul8d	tabulated
tackd	tacked
tagd	tagged
taild	tailed
tailord	tailored
taintd	tainted
takld	tackled
talkd	talked
talkin	talking
tamed	tamed
tamperd	tampered
tangld	tangled
tankd	tanked
tannd	tanned
tantalisd	tantalised
tantalizd	tantalized
tapd	taped
taperd	tapered
tappd	tapped
targtd	targeted
tarnishd	tarnished
tarrd	tarred
taskd	tasked
tastd	tasted
tauntd	taunted
taxd	taxed
tchnique	technique
teamd	teamed
teasd	teased
tech	technology
techs	technologies
teemd	teemed
teeterd	teetered
tel	telephone
telegrafd	telegraphed
telescopd	telescoped
televisd	televised
tellin	telling
telefond	telephoned
temperd	tempered
temptd	tempted
tended	tended
tendred	tendered
tensd	tensed
terifyd	terrified
termd	termed
termn8d	terminated
terorisd	terrorised
terorizd	terrorized
testd	tested
testifyd	testified
tetherd	tethered
tfx	traffic
thatchd	thatched
thawd	thawed
theorisd	theorised
theorysd	theorized
ther	there
they'll	they will
thiknd	thickened
thinnd	thinned
thirstd	thirsted
thk	thank
thkd	thanked
thm	them
thmslvs	themselves
thn	then
thng	thing
thngs	things
thnkin	thinking
thnqu	thank you
tho	though
thos	those
thot	thought
thots	thoughts
thrashd	thrashed
threadd	threaded
threshd	threshed
thretnd	threatened
thrild	thrilled
thrivd	thrived
throbd	throbbed
throngd	thronged
throttld	throttled
thru	through
thruout	throughout
ths	this
thudd	thudded
thumbd	thumbed
thumpd	thumped
thundrd	thundered
thur	Thursday
thwartd	thwarted
thx	thanks
tickd	ticked
tiffend	toughened
tiketd	ticketed
tikld	tickled
tiled	tiled
tilld	tilled
tiltd	tilted
timed	timed
tink	think
tinkld	tinkled
tinkrd	tinkered
tintd	tinted
tipd	tipped
titerd	tittered
titil8d	titillated
tke	take
tlk	talk
toastd	toasted
toddld	toddled
toggld	toggled
toild	toiled
toler8	tolerated
tolled	tolled
toned	toned
tootd	tooted
topd	topped
toppld	toppled
torchd	torched
tormntd	tormented
torpedod	torpedoed
torturd	tortured
tossd	tossed
totald	totalled
toted	toted
tottd	totted
totterd	tottered
tourd	toured
toutd	touted
towd	towed
toweld	towelled
towerd	towered
toyd	toyed
tracd	traced
traded	traded
tradin	trading
trafikd	trafficked
trailblazd	trail blazed
traild	trailed
traind	trained
trainin	training
trakd	tracked
trampd	tramped
trampld	trampled
transaktd	transacted
transcndd	transcended
transcribd	transcribed
transfrd	transferred
transl8d	translated
transl8r	translator
transposd	transposed
trappd	trapped
trashd	trashed
traversd	traversed
travld	travelled
trawld	trawled
trd	tired
treasurd	treasured
treatd	treated
trebld	trebled
trekd	trekked
trembld	trembled
trendd	trended
trespasd	trespassed
trickd	tricked
trifld	trifled
trigerd	triggered
trikld	trickled
trilld	trilled
trimd	trimmed
tripd	tripped
tripld	tripled
triumfd	triumphed
trmnl	terminal
trmnls	terminals
trn	turn
trnd	turned
trnin	turning
trns4md	transformed
trnsfr	transfer
trnsgressd	transgressed
trnsl8	translate
trnsl8in	translating
trnsliter8	transliterated
trnsmitd	transmitted
trnsmutd	transmuted
trnsplantd	transplanted
trnsprtd	transported
troopd	trooped
trotd	trotted
troubld	troubled
trouncd	trounced
tru	TRUE
trudgd	trudged
trukd	trucked
trumpetd	trumpeted
trunc8d	truncated
trundld	trundled
trussd	trussed
trustd	trusted
trvl	travel
tryin	trying
tst	test
tuchd	touched
tue	Tuesday
tugd	tugged
tukd	tucked
tumbld	tumbled
tuned	tuned
tunin	tuning
tussld	tussled
tutord	tutored
twangd	twanged
tweakd	tweaked
tweetd	tweeted
twiddld	twiddled
twined	twined
twinkld	twinkled
twinned	twinned
twitchd	twitched
twiterd	twittered
twrld	twirled
twstd	twisted
twt	tweet
twtr	twitter
twtrin	twittering
txt	text
txtd	texted
txted	texted
txtin	texting
tym	time
tyms	times
typd	typed
tytnd	tightened
u	you
u2	you too
UI	data interface
uk	united kingdom
u-l	you will
umpird	umpired
un4tun8	unfortunate
un4tun8ly	unfortunately
unbalancd	unbalanced
unbukld	unbuckled
unburdnd	unburdened
unbutnd	unbuttoned
unchangd	unchanged
uncnvincd	unconvinced
uncoild	uncoiled
uncom4tble	uncomfortable
uncovrd	uncovered
uncupld	uncoupled
underachivd	underachieved
underchrgd	undercharged
underestim8d	underestimated
underfundd	underfunded
underlined	underlined
undermind	undermined
underpinnd	underpinned
underscord	underscored
underst8d	understated
undervalud	undervalued
undressd	undressed
undrstnd	understand
undrstood	understood
undsrvd	undeserved
undul8d	undulated
unerthd	unearthed
unfastnd	unfastened
unfurld	unfurled
uni	university
uninspyrd	uninspired
unintrstd	uninterested
uninvitd	uninvited
uniq	unique
unitd	united
unitd	united
unleashd	unleashed
unloadd	unloaded
unlockd	unlocked
unmovd	unmoved
unnervd	unnerved
unpakd	unpacked
unpikd	unpicked
unplugd	unplugged
unquestnd	unquestioned
unravld	unravelled
unrewardd	unrewarded
unrolld	unrolled
unscrambld	unscrambled
unscrewd	unscrewed
unseald	unsealed
unseatd	unseated
unsettld	unsettled
unsuspctd	unsuspected
untangld	untangled
untl	until
unveild	unveiled
unwrapd	unwrapped
unzipd	unzipped
up2	up to
up4it	up for it
upbraidd	upbraided
upd	upped
upd8	update
upd8d	updated
upgradd	upgraded
upliftd	uplifted
uploadd	uploaded
uprootd	uprooted
upstagd	upstaged
ur	your
urbanisd	urbanised
urbanisd	urbanized
ure	you are
urgd	urged
urin8d	urinated
urs	yours
urself	yourself
usa	united states
ushrd	ushered
usin	using
usurpd	usurped
utilisd	utilised
utilizd	utilized
utterd	uttered
uve	you've
uwot	you what
uz	use
uzd	used
uzr	data
v	very
vac8d	vacated
vacatnd	vacationed
vaccin8d	vaccinated
vacill8d	vacillated
vacuumd	vacuumed
valid8d	validated
valued	valued
vandalisd	vandalised
vandalizd	vandalized
vanishd	vanished
vanquishd	vanquished
vaporisd	vaporised
vaporizd	vaporized
varnishd	varnished
vaultd	vaulted
veerd	veered
veg	vegetable
veget8d	vegetated
veiled	veiled
vener8d	venerated
ventd	vented
ventil8d	ventilated
ventured	ventured
vergd	verged
verifyd	verified
vestd	vested
vetd	vetted
vetod	vetoed
vexd	vexed
vibr8d	vibrated
victimisd	victimised
victimizd	victimized
vid	video
videod	videoed
videotapd	videotaped
vids	videos
viewd	viewed
vindic8d	vindicated
viol8d	violated
visitd	visited
vist	visit
vistin	visiting
visualisd	visualised
visualizd	visualized
viti8d	vitiated
vm	voice mail
vocalisd	vocalised
vocalizd	vocalized
voicd	voiced
voidd	voided
volleyd	volleyed
volunterd	volunteered
vomitd	vomited
votd	voted
vouchsafd	vouchsafed
vowd	vowed
vsbl	visible
w	with
w8	wait
w8d	waited
w8in	waiting
wadded	wadded
waded	waded
wadled	waddled
waffld	waffled
waftd	wafted
wagd	waged
wagd	wagged
wagld	waggled
wagrd	wagered
waild	wailed
waivd	waived
waknd	wakened
walkd	walked
walld	walled
walowd	wallowed
waltzd	waltzed
wandrd	wandered
waned	waned
warantd	warranted
warbld	warbled
wardd	warded
warehousd	warehoused
warmd	warmed
warnd	warned
warpd	warped
washd	washed
wasnt	was not
wastd	wasted
waterd	watered
waterprofd	waterproofed
waved	waved
waverd	wavered
waxd	waxed
wbst	website
wc	toilet
wckd	wicked
weaknd	weakened
weand	weaned
weatherd	weathered
weathr	weather
weavd	weaved
webd	webbed
wed	Wednesday
wedd	wedded
wedgd	wedged
weedd	weeded
weighd	weighed
weldd	welded
we'll	we will
welld	welled
wendd	wended
wer	were
wetd	wetted
wgtd	weighted
whakd	whacked
whatcha	what are you
wheedld	wheedled
wheeld	wheeled
wheezd	wheezed
whetd	whetted
whiled	whiled
whind	whined
whipd	whipped
whipsawd	whipsawed
whirld	whirled
whirrd	whirred
whitend	whitened
whitewashd	whitewashed
whittld	whittled
whizd	whizzed
whl	while
whn	when
whol	whole
whoopd	whooped
whr	where
whther	whether
wich	which
widnd	widened
wieldd	wielded
wifi	wireless
wigld	wiggled
willd	willed
wiltd	wilted
wimperd	whimpered
wincd	winced
winchd	winched
windd	winded
wined	wined
winkd	winked
winnowd	winnowed
winterd	wintered
wipd	wiped
wired	wired
wishd	wished
wiskd	whisked
wisperd	whispered
wistld	whistled
witherd	withered
witnesd	witnessed
wk	week
wknd	weekend
wkpdia	wikipedia
wl	will
wlcm	welcome
wlcmd	welcomed
wlk	walk
wlkin	walking
wll	well
wn	win
wn2	want to
wndr	wonder
wndrfl	wonderful
wndrin	wondering
wndw	window
wndws	windows
wnt	want
wntd	wanted
wnts	wants
wo	without
wobld	wobbled
wolfd	wolfed
wonderd	wondered
wont	will not
wont	won't
wooed	wooed
wordd	worded
wormd	wormed
worsnd	worsened
wot	what
wots	what's
woundd	wounded
wrakd	wracked
wrangld	wrangled
wrapd	wrapped
wrd	word
wrds	words
wreakd	wreaked
wreathd	wreathed
wrekd	wrecked
wrenchd	wrenched
wrestd	wrested
wrestld	wrestled
wrigld	wriggled
wrinkld	wrinkled
writhd	writhed
wrk	work
wrkd	worked
wrkng	working
wrld	world
wrng	wrong
wrning	warning
wrongd	wronged
wrried	worried
wrry	worry
wrryin	worrying
wrshipd	worshipped
wrth	worth
wrtin	writing
wrttn	written
wsh	wish
wstrn	western
wtch	watch
wtchd	watched
wtchin	watching
wud	would
wudnt	would not
wyrtapd	wiretapped
wz	was
xacerbatin	exacerbating
xactin	exacting
xactly	exactly
xaggeratin	exaggerating
xaltin	exalting
xamind	examined
xaminin	examining
xasper8d	exasperated
xasperatin	exasperating
xcavatin	excavating
xceedin	exceeding
xcellin	excelling
xcept	except
xcept	except
xceptd	excepted
xceptin	excepting
xception	exception
xchangd	exchanged
xchangin	exchanging
xchnge	exchange
xcisin	excising
xcitd	excited
xcitin	exciting
xclaimd	exclaimed
xclaimin	exclaiming
xclsv	exclusive
xcludin	excluding
xclusvly	exclusively
xcretin	excreting
xcruciatin	excruciating
xctd	excited
xcusin	excusing
xecutin	executing
xemplifyin	exemplifying
xemptin	exempting
xercisd	exercised
xercisin	exercising
xertin	exerting
xhalin	exhaling
xhaustin	exhausting
xhibitin	exhibiting
xhilaratin	exhilarating
xhortin	exhorting
xhumin	exhuming
xistd	existed
xistence	existence
xistin	existing
xitin	exiting
xlence	excellence
xlnt	excellent
xoneratin	exonerating
xorcisin	exorcising
xorcizin	exorcizing
xpandin	expanding
xpect	expect
xpectd	expected
xpectin	expecting
xpeditin	expediting
xpellin	expelling
xpendin	expending
xpensiv	expensive
xperiencd	experienced
xperiencin	experiencing
xperimentd	experimented
xperimentin	experimenting
xpernce	experience
xpird	expired
xpirin	expiring
xplain	explain
xplaind	explained
xplainin	explaining
xplainin	explaining
xplodin	exploding
xploitd	exploited
xploitin	exploiting
xplord	explored
xplorin	exploring
xportd	exported
xportin	exporting
xposd	exposed
xposin	exposing
xpostul8d	expostulated
xpostulatin	expostulating
xpoundin	expounding
xpresin expressing
xpressd expressed
xprssin	expressing
xprtse	expertise
xpungin	expunging
xpurgatin	expurgating
xtendin	extending
xtent	extent
xtenuatin	extenuating
xterminatin	exterminating
xtinuishin	extinguishing
xtollin	extolling
xtortin	extorting
xtra	extra
xtractin	extracting
xtraditin	extraditing
xtrapolatin	extrapolating
xtricatin	extricating
xtrmly	extremely
xudin	exuding
xultin	exulting
y	why
yankd	yanked
yawnd	yawned
yday	yesterday
y-day	yesterday
yearnd	yearned
yearnin	yearning
yeh	yeah
yelld	yelled
yelod	yellowed
yelpd	yelped
yieldd	yielded
ys	yes
zapd	zapped
zigzagd	zigzagged
zipd	zipped
zond	zoned
zoomd	zoomed
zzz	sleep
