2k0	2000
2k1	2001
2k4	2004
2k6	2006
2k7	2007
2k8	2008
2k9	2009
nwb	a new person
avsb	a very special boy
bout	about
bowt	about
awol	absent without leave
jumping the couch	acting strange
rodger	affirmative
roger	affirmative
roj	affirmative
n199312	african american
n1994	african american
ayb	All Your Base
aybab2m	all your base are belong 2 me
aybabtg	All Your Base Are Belong To Google
aybab2u	All your base are belong to us
aybabtu	all your base are belong to us
ayte	alright
i8	alright
ight	alright
iigh	alright
iight	alright
ite	alright
m	am
lollercaust	an extreme event of hilarity
n	and
nd	and
awsic	and why should i care
aypi	And Your Point Is
aypi	and your point is
flames	angry comments
flamer	angry poster
n e	any
ne	any
neday	any day
nedn	any day now
neida	any idea
nemore	Anymore
ne1	anyone
ny1	Anyone
nefing	anything
nethin	anything
nething	anything
neway	anyway
nywy	anyway
newais	Anyways
neways	anyways
newayz	anyways
newez	anyways
r	are
ru	are you
ruabog	are you a boy or girl
ruagoab	are you a girl or a boy
ayagob	are you a girl or boy
rua	are you alone
rubz2nt	are you busy tonight
ayd	are you done
aydy	are you done yet
ayfr	are you for real
ayfk	are you fucking kidding
ayfkm	are you fucking kidding me
rufkm	are you fucking kidding me
ayfs	Are You Fucking Serious
rugay	are you gay
rugta	are you going to answer
ruh	are you horny
ayk	are you kidding
aykm	are you kidding me
rukm	are you kidding me
ayl	are you listening
rumf	Are you male or female
aymf	are you my friend
ruk	are you ok?
ruok	are you ok?
ayok	are you okay
rur	are you ready
ays	are you serious
aysm	are you shitting me?
ayst	are you still there
ayt	are you there
rut	are you there
aytf	are you there fucker
ayty	are you there yet
ruwm	are you watching me
fankle	area between foot and ankle
rnt	aren't
sif	as if
sifn't	as if not
ayw	as you wish
azn	asian
 @$$	ass
azz	ass
 @$$ #013	ass hole
 @hole	asshole
 @h	asshole
azhol	asshole
@	at
ayec	at your earliest convenience
avie	Avatar
avtr	avatar
avvie	avatar
avy	Avatar
av7x	avenged sevenfold
ayc	awaiting your comments
awes	awesome
awsm	awesome
awsome	awesome
awk	awkward
bbz	babes
babi	baby
bbe	baby
bbi	Baby
bby	baby
bebe	baby
bilu	baby i love you
bak	back
bakk	back
bck	back
bk	back
bau	back at you
bhwu	back home with you
biab	back in a bit
biaf	Back In A Few
btfo	back the fuck off
b2w	Back to work
b2u	back to you
bty	back to you
bwpwap	back when Pluto was a planet
b/g	background
bg	background
bamf	bad ass mother fucker
bl	bad luck
b8	bait
balz	balls
b&	banned
b@	banned
bbp	Banned by parents
bnr	banner
bbbj	Bare Back Blow Job
bol	Barking Out Loud
bstrd	Bastard
bofh	bastard operator from hell
bsmfh	Bastard System Manager From Hell
br	bathroom
b82rez	Batteries
b8rez	Batteries
b3	be
bbfu	be back for you
bbiab	be back in a bit
bbiaf	be back in a few
bbifs	be back in a few seconds
bbialb	Be back in a little bit
bbilb	be back in a little bit
bbiam	be back in a minute
bbias	be back in a second
bbiaw	be back in a while
bbilfm	be back in like five minutes
bbim	Be Back In Minute
bbl	be back later
bbl8a	Be Back Later
bblig	Be back later...i guess
bbml	be back much later
bbn	be back never
bbol	be back online later
bbq	be back quick
bbsts	be back some time soon
bbs	be back soon
bbt	be back tomorrow
bbtn	be back tonite
bbvl	Be Back Very Later
bbwl	be back way later
bbw	be back whenever
bbwe	be back whenever
bmf	be my friend
bmvp	be my valentine please
bnol	be nice or leave
brb	be right back
brbf	Be Right Back Fucker
brbl	be right back later
brbmf	be right back mother fucker
brbs	be right back soon
brbts	be right back taking shit
brfb	be right fucking back
brh	be right here
brt	be right there
bcnu	be seeing you
bcnul8r	be seeing you later
bsxc	be sexy
bttyl	be talking to you later
btias	Be there in a second
bts	be there soon
burma	be undressed ready my angel
bytabm	beat you to a bloody mess
btsoom	Beats The Shit Out Of Me
btfl	beautiful
b-cuz	because
b/c	because
b/cos	because
bc	because
bcoz	Because
bcuz	because
becuse	because
becuz	because
cos	because
coz	because
cuz	because
cuzz	Because
bcurl8	Because you're late.
bn	been
btdt	been there done that
grog	beer
b4	before
be4	before
b4u	before you
bleve	believe
bion	Believe it or not.
bndm3ovr	Bend me over
boati	Bend Over And Take It
bohic	Bend over here it comes
bdfl	Benevolent Dictator For Life
bbf	best boy friend
bbfs	best boyfriends
bbwb	best buddy with boobs
bestie	best friend
bezzie	best friend
bffeae	Best Friend For Ever And Ever
b.f.f.	best friend forever
bff	best friend forever
bfitww	best friend in the whole world
bffaw	best friends for a while
bffa	best friends for always
bf4e	best friends for ever
bffene	Best Friends For Ever And Ever
bf4l	best friends for life
bffl	best friends for life
bffn	best friends for now
bf4eva	Best Friends forever
bffe	Best friends forever
bffaa	Best Friends Forever And Always
bffae	Best Friends Forever And Ever
bfftddup	best friends forever till death do us part
bma	best mates always
bm4l	best mates for life
bmfl	best mates for life
bmfe	best mates forever
bmttveot	best mates till the very end of time
bobw	Best of Both Worlds
brgds	best regards
betcha	bet you
bettr	better
btr	better
bka	better known as
blnt	Better Luck Next time
btcn	Better than Chuck Norris
b/t	between
b/w	between
btwn	between
bmay	between me and you
bm&y	between you and me
bab	Big ass Boobs
bigd	big deal
bfhd	big fat hairy deal
bfd	big fucking deal
bfg	big fucking gun
bft	big fucking tits
bmoc	Big Man On Campus
bpot	big pair of tits
bwoc	Big Woman On Campus
b-day	birthday
b'day	birthday
bd	birthday
bday	birthday
bsx	bisexual
biwm	bisexual white male
b/s/l	Bisexual/Straight/Lesbian
bt	bit torrent
13itch	bitch
81tc#	bitch
b1tch	Bitch
bch	bitch
beatch	bitch
beech	bitch
beeoch	bitch
beezy	BITCH
beotch	bitch
betch	Bitch
beyatch	Bitch
beyotch	bitch
biach	bitch
biatch	bitch
bich	Bitch
biotch	bitch
bish	Bitch
bizatch	Bitch
biznatch	bitch
biznitch	bitch
bizzle	BITCH
btch	bitch
bytch	bitch
bamofo	bitch ass mother fucker
bfh	bitch from hell
bstfu	bitch shut the fuck up
bm	Bite Me
bmha	bite my hairy ass
blk	black
blkm	Black Male
bbm	BlackBerry Messenger
bml	bless my life
blg	blog
bleme	blog meme
bh	bloody hell
bioya	blow it out your ass
bsomn	blowing stuff out my nose
byak	blowing you a kiss
bj	blowjob
blj	blowjob
bljb	Blowjob
blu	blue
bsod	blue screen of death
bo	body odour
bonr	boner
8008	boob
bewb	boob
8008135	boobies
80085	Boobs
bewbs	boobs
bewbz	boobs
b00t	boot
bewt	boot
bord	bored
brd	bored
blh	bored like hell
boomm	bored out of my mind
btd	bored to death
biw	boss is watching
bos	boss over shoulder
boffum	Both of them
bovered	bothered
btm	bottom
boxor	box
boi	boy
bf	boyfriend
bf+gf	boyfriend and girlfriend
bfs	Boyfriends
bf's	boyfriend's
brbbrb	br right back bath room break
bnib	Brand new in Box
buwu	breaking up with you
baf	bring a friend
byoc	bring our own computer
byob	Bring your own Beer
hoopty	broke down automobile
b0rked	broken
bb4h	bros before hoes
bro	brother
broseph	brother
brover	Brother
bruh	brother
bruhh	Brother
bruv	brother
bruva	brother
bfam	brother from another mother
bilf	brother i'd like to fuck
bros	brothers
bruz	brothers
bukket	bucket
bw3	Buffalo Wild Wings
bzns	buisness
b.s.	bullshit
bs	bullshit
bfe	Bum Fuck Egypt
bogsatt	bunch of guys sitting around the table
bubar	bushed up beyond all recognition
biz	Business
b2b	business to business
bizi	Busy
buszay	busy
bz	busy
bzy	busy
bzzy	busy
bicbw	but I could be wrong
botoh	but on the other hand
bwt	but when though
bykt	But you knew that
budzecks	butt sex
butsecks	butt sex
but6	buttsex
bogo	buy one get one
bogof	buy one get one free
byself	by myself
btb	by the by
btfw	by the fucking way
btw	by the way
btwilu	by the way i love you
btwitiailwu	by the way i think i am in love with you
bwim	by which i mean
bi	bye
bai	Bye
bii	bye
bubi	bye
bb	bye bye
bibi	bye bye
buhbi	Bye Bye
byes	bye bye
bbfn	Bye Bye for now
bibifn	bye bye for now
b4n	bye for now
bfn	bye for now
bb4n	Bye-bye for now
cm	call me
cmitm	Call me in the morning
cml	call me later
cml8r	call me later
cmliuw2	call me later if you want to
cmomc	call me on my cell
cmcp	call my cell phone
cmh	Call My House
cod	Call of Duty
cod4	call of duty 4
cod5	call of duty 5
ctc	call the cell
cybl	call you back later
curn	calling you right now
ctfd	calm the fuck down
c 2 c	cam to cam (webcams)
cam	camera
cn	can
cihswu	can i have sex with you
cubi	can you believe it
cw2cu	can`t wait to see you
c14n	canonicalization
cnt	can't
cba	can't be arsed
cbb	can't be bothered
cbf	cant be fucked
cbfed	can't be fucked
cbfa	can't be fucking arsed
cbi	can't believe it
cr	Can't remember
crs	can't remember shit
csl	can't stop laughing
c/t	can't talk
ct	can't talk
ctn	can't talk now
ctnbos	can't talk now boss over shoulder
ctncl	Can't talk now call later
ctpos	Can't Talk Parent Over Sholder
ctpc	cant talk parent(s) coming
ctrn	can't talk right now
cwtgypo	can't wait to get your panties off
cptn	captain
ctf	capture the flag
cfas	care for a secret?
c4ashg	care for a shag
c2c	care to chat?
c@	cat
cuwul	catch up with you later
cylbd	catch ya later baby doll
celly	cell phone
cts	change the subject
ctt	change the topic
char	character
chr	character
ch@	chat
cwyl	chat with ya later
chk	check
cfid	check for identification
cotm	check out this myspace
peep dis	check out what I'm telling you
cylor	check your local orhtodox rabbi
cym	check your mail
cheezburger	cheeseburger
chik	chick
cilf	child i'd like to fuck
cp	child porn
chilax	chill and relax in one word
ctfo	chill the fuck out
xoac	Christ on a crutch
xmas	christmas
cvq	chucking very quietly
ctm	chuckle to myself
cancer stick	cigarette
cig	cigarette
cowboy choker	cigarette
zig	cigarette
cigs	cigarettes
ccna	Cisco Certified Network Associate
cless	clanless
cob	close of business
cye	Close Your Eyes
404	Clueless
cluebie	clueless newbie
yayo	cocaine
cawk	Cock
cskr	cock sucker
cd9	Code 9 (other people nearby)
c|n>k	coffee through nose into keyboard
cwmaos	coffee with milk and one sugar
crunk	combination of crazy and drunk
cmbo	combo
cb	come back
cfm	come fuck me
chswm	come have sex with me
chswmrn	come have sex with me right now
c'mon	Come On
cmon	Come on
coiwta	come on i wont tell anyone
c2	come to
cwm	come with me
comin'	coming
c&c	Command and Conquer
cnc	Command and Conquer
cmt	comment
comnt	comment
c/b	comment back
cmb	comment me back
cmplte	complete
catwot	complete and total waste of time
cwot	complete waste of time
cmplcdd	complicated
comp	Computer
compy	computer
pooter	Computer
puter	Computer
cis	computer information science
cg	Congratulations
congrats	congratulations
grats	congratulations
gratz	congratulations
cid	consider it done
cms	content management system
contrib	contribution
contribs	contributions
ctrl	control
convo	conversation
coo	cool
k3wl	cool
kewel	cool
kewl	cool
kl	cool
koo	cool
kool	cool
kuhl	cool
kul	cool
kuwl	cool
kwl	cool
ql	cool
qool	cool
qoolz	cool
clm	Cool Like Me
clt	Cool Like That
5-oh	cop
6up	cops in area
cpy	copy
hiybbprqag	copying somebody else's search results
copyvio	copyright violation
cmiiw	correct me if I'm wrong
cpm	cost per 1000 impressions
cood	could
cud	could
culd	Could
ccl	Couldn't Care Less
cgad	couldn't give a damn
cgaf	couldn't give a fuck
cs	Counter-Strike
cs:s	Counter-Strike: Source
cuple	couple
cma	Cover My Ass
c.y.a	cover your ass
ctfu	cracking the fuck up
crp	crap
cr8	crate
crzy	crazy
crazn	crazy asian
cre8or	creator
xing	crossing
xover	crossover
xroads	crossroads
cmar	cry me a river
qq	crying eyes
cmao	Crying My Ass Off
cmeo	crying my eyes out
cof	Crying on the floor
cotf	crying on the floor
col	crying out loud
crm	customer relationship management
c2tc	cut to the chase
cut3	cute
kute	cute
cgf	cute guy friend
ciwwaf	cute is what we aim for
qt	cutie
qte	cutie
qt3.14	cutie pie
qtpi	cutie pie
cmw	cutting my wrists
cyb	cyber
cybr	cyber
cpl	Cyber Athlete Professional League
cybseckz	cyber sex
dilf	dad i'd like to fuck
dayum	damn
dayumm	damn
dmn	damn
dtl	damn the luck
dyac	damn you auto correct
du2h	damn you to hell
dy2h	damn you to hell
dyth	Damn You To Hell
ddr	dance dance revolution
dnimb	dancing naked in my bra
dotc	dancing on the ceiling
db	database
d8	date
dob	date of birth
dil	Daughter in law
daii	day
dod	Day of Defeat
doa	dead on arrival
d2m	dead to me
dwi	deal with it
dwioyot	Deal With It On Your Own Time
dm	deathmatch
dsided	decided
defs	definetly
def	definitely
dhv	Demonstration of Higher Value
don	denial of normal
dos	denial of service
doypov	depends on your point of view
dprsd	depressed
dit	Details in Thread
d2	Diablo 2
d1ck	dick
dih	dick in hand
dh	dickhead
dikhed	dickhead
dctnry	dictionary
dnrta	did not read the article
dnrtfa	did not read the fucking article
dju	did you
dugt	did you get that?
dygtp	did you get the picture
duk	did you know
dyk	did you know
din	didn't
din't	didn't
diacf	die in a car fire
diaf	die in a fire
diah	die in a hole
dirl	Die in real life
diez	dies
diff	difference
ddl	direct download
d/c	disconnected
dc'd	disconnected
dp	display picture
ddos	Distributed Denial of Service
d&c	divide and conquer
dafs	do a fucking search
dic	do i care
diku	do i know you
diky	Do I know you
dillic	Do I look like I care
dillifc	do I look like I fucking care
dilligad	do I look like I give a damn
dilligaf	do I look like I give a fuck
dilligas	do i look like i give a shit
diy	do it yourself
dmaf	do me a favor
dnd	Do Not Disturb
dndp	Do not double post
dnw	Do not want
dtrt	do the right thing
dya	Do you
dycotfc	do you cyber on the first chat
dugi	do you get it?
dynm	do you know me
dylh	do you like him
dulm	do you like me
dylos	do you like oral sex
dylm	do you love me
dym	Do you mind
dynk	do you not know
ducy	do you see why
dyw2gwm	do you want to go with me
dywtmusw	do you want to meet up some where
dhly	does he like you
d/m	Doesn't Matter
doin	doing
doin'	doing
dcw	Doing Class Work
dnt	don't
dont	don't
dun	don't
damhik	don't ask me how I know
damhikijk	Don't Ask Me How I Know -  I Just Know
damhikt	don't ask me how I know this
dadt	Don't ask. Don't tell.
dbab	don't be a bitch
dbafwtt	Don't Be A Fool Wrap The Tool
dbg	don't be gay
dbh	don't be hating
dbi	Don't Beg It
dbeyr	don't believe everything you read
dbm	don't bother me
dc	don't care
dd	don't die
degmt	Don't Even Give Me That
detai	don't even think about it
dftba	don't forget to be awesome
dfu	don't fuck up
dfw/m	Don't Fuck with Me
dfwm	Don't Fuck with Me
dfc	DON'T FUCKING CARE
dfwmt	Don't fucking waste my time
dgms	Don't get me started
dgypiab	don't get your panties in a bunch
dgac	don't give a crap
dgaf	don't give a fuck
dgara	don't give a rats ass
dgas	Don't give a shit
dg	don't go
dga	don't go anywhere
dgoai	don't go on about it
dgt	don't go there
dhac	Don't have a clue
dk	don't know
dn	don't know
dno	don't know
donno	don't know
duno	don't know
dlibu	Dont let it bother you
dln	don't look now
dmi	don't mention it
dmu	don't mess up
dmwm	don't mess with me
dmy	don't mess yourself
dpmo	don't piss me off
dqydj	don't quit your day job
dqmot	don't quote me on this
drc	don't really care
dsu	don't screw up
dttm	don't talk to me
dttml	don't talk to me loser
dttpou	Don't tell the police on us
dttriaa	don't tell the RIAA
dtb	don't text back
dts	Don't think so
dta	Don't Trust Anyone
dtp	Don't Type Please
dwt	don't wanna talk
dwmt	don't waste my time
dwy	don't wet yourself
d.w	don't worry
d/w	don't worry
dw	don't worry
dwai	don't worry about it
dwbi	Don't worry about it.
doncha	Don't you
dontcha	don't you
dyec	Don't You Ever Care
dutma	don't you text me again
dyt	Don't you think
dyw	don't you worry
dt	double team
dbag	douchebag
dwn	down
dftc	down for the count
dfw	down for whatever
d.t.f	down to fuck
dth	down to hang
d/l	download
dl	download
dbz	DragonBall Z
drm	dream
db4l	drinking buddy for life
dwb	Driving while black
ddg	Drop Dead Gorgeous
dlf	dropping like flies
d&df	drug & disease free
ddf	Drug and Disease Free
dr00d	druid
drood	druid
knackered	drunk
d00d	dude
dewd	Dude
dood	dude
doodz	dudes
dah	dumb as hell
dass	dumb ass
df	Dumb Fuck
dfo	dumb fucking operator
dmba*	dumbass
dupe	duplicate
etp	eager to please
ez	Easy
ezi	easy
e4u2s	easy for you to say
ead	eat a dick
emp	eat my pussy
esad	eat shit and die
esadyffb	eat shit and die you fat fucking bastard
esl	eat shit loser
xtc	ecstasy
edumacation	education
efct	effect
skeet	ejaculate
e-ok	Electronically OK
1337	elite
133t	elite
31337	elite
313373	elite
31ee7	elite
el!t	elite
l337	elite
l33t	elite
lee7	elite
leet	elite
emm	email me
911sc	emergency let's stop chatting
epa	Emergency Parent Alert
mle	emily
mnm	eminem
emo	emotional
eob	End of Business
eoc	end of conversation
eod	End of day
eof	end of file
eom	end of message
eos	end of story
eotw	end of the world
eot	end of transmission
eula	end data license agreement
nme	enemy
nrg	energy
njoy	enjoy
enof	enough
enuf	enough
enuff	enough
nuff	enough
nv	envy
ecf	error carried forward
esc	escape
eta	Estimated Time of Arrival
evn	even
eva	ever
evaa	ever
evar	ever
evr	ever
eq	Everquest
evercrack	Everquest
eq2	Everquest2
evry	every
enat	every now and then
evry1	every one
butterface	every thing is hot but her face
ev1	everyone
every1	everyone
esbm	Everyone sucks but me
errythin	everything
evrytin	everything
3vi1	evil
*eg*	evil grin
eg	evil grin
xyz	examine your zipper
xyzpdq	Examine Your Zipper Pretty Darn Quick
e.g.	example
xmpl	example
ex-bf	Ex-Boy Friend
xbf	ex-boyfriend
xellent	excellent
xlnt	Excellent
xcept	except
xcpt	except
xpt	except
xs	excess
ex-gf	Ex-Girl Friend
xgf	exgirlfriend
xit	Exit
xpect	expect
exp	experience
xp	experience
guru	expert
etmda	Explain it to my dumb ass
xplaned	explained
eil	explode into laughter
sploits	exploits
sploitz	exploits
etla	extended three letter acronym
xtra	extra
efffl	extra friendly friends for life
xl	extra large
x treme	extreme
xtreme	extreme
xd	extreme droll
eleo	Extremely Low Earth Orbit
eyez	eyes
fab	fabulous
f4c3	face
f2f	face to face
ftf	face to face
f.b.	facebook
fbk	facebook
fcbk	facebook
phag	fag
faggit	faggot
fgt	faggot
phail	fail
phayl	fail
ftbfs	Failed to build from source
fbimcl	Fall Back In My Chair Laughing
fofl	fall on the floor laughing
ffcl	falling from chair laughing
focl	Falling Off Chair Laughing.
foocl	falls out of chair laughing
fam	family
fmir	family member in room
fnci	fancy
fol	farting out loud
fst	fast
f@	fat
fe	fatal error
f8	fate
fav	Favorite
fave	favorite
ph33r	fear
ph34r	fear
phear	fear
fpmitap	federal pound me in the ass prison
fotcl	fell off the chair laughing
f4f	female for female
f4m	female for male
poontang	female genitalia
fov	Field of View
fio	figure it out
fxp	file exchange protocol
ftp	file transfer protocol
pino	Filipino
fitb	fill in the blank
ffxi	Final Fantasy 11
5n	fine
f9	fine
fi9	fine
fbtw	Fine Be That Way
fwm	Fine With Me
fcfs	first come first served
fn	first name
fps	First Person Shooter
fp	first post
fiv	five
fify	Fixed It For You
ftfy	Fixed that for you
fyp	fixed your post
fotm	Flavour of the month
fsm	flying spaghetti monster
folo	Follow
fft	food for thought
foo	fool
4	for
fer	for
ferr	For
fo`	for
faic	For All I Care
fao	for attention of
4col	For crying out loud
fcol	for crying out loud
4evr	for ever
4fs	for fuck's sake
ffs	for fuck's sake
ffr	for future reference
fgs	for God's sake
fgssu	For Gods sake shut up
floabt	for lack of a better term
4lyf3	for life
4lyfe	for life
fnar	For No Apparent Reason
fnpr	for no particular reason
4r3al	for real
fsr	for some reason
4sho	for sure
fashizzle	for sure
fo shizzle	for sure
fo sho	for sure
for sheeze	for sure
foshizzle	for sure
fosho	for sure
fs	For Sure
fsho	for sure
ftfw	For the fucking win!
ftk	For the Kill
ftlt	For the last time
ftl	For The Lose
4tlog	for the love of god
ftlog	for the love of god
ftmp	For the most part
ftmfw	for the mother fucking win
ftr	For The Record
fttp	for the time being
4tw	for the win
ftw	For the win!
4us	for us
fwiw	for what it's worth
4u	for you
4umb	For You Maybe
fya	for your attention
fye	For Your Entertainment
fyeo	For your eyes only
fyfi	For Your Fucking Information
fyi	for your information
fyk	for your knowledge
fyl	For your Love
4head	forehead
4eva	forever
4ever	forever
4evs	forever
4e&e	forever and ever
f&e	forever and ever
fimh	forever in my heart
4g8	forget
4get	forget
fuhget	forget
4gai	forget about it
4geit	forget it
4getu	forget you
4give	forgive
4gv	forgive
4got	forgot
frgt	forgot
4m	form
42n8	fortunate
4ward	forward
4wd	forward
fwd	forward
fxe	foxy
frk	freak
phreak	freak
friggin	freaking
ffa	free for all
f2p	free to play
f2t	Free to talk
foia	freedom of information act
fmao	freezing my ass of
faq	frequently asked question
fob	fresh off the boat
dawg	Friend
dogg	friend
fren	friend
frnd	friend
homey	Friend
m8	friend
whodi	friend
foaf	friend of a friend
ff	friendly fire
frens	friends
frnds	friends
m473s	friends
m473z	friends
m8t's	friends
f4eaa	friends forever and always
fwb	Friends with Benefits
fwob	friends with occasional benefits
4rm	from
frm	from
fta	From The Article
ftfa	From The Fucking Article
ft2t	From time to time
fsod	frosn screen of death
fc	fruit cake
7uck	fuck
ef	Fuck
farg	fuck
fawk	fuck
fck	fuck
fcuk	fuck
feck	fuck
fk	fuck
fook	fuck
fuk	fuck
fukk	fuck
fux	fuck
fvck	fuck
phuck	fuck
phuk	fuck
phux	Fuck
phuxor	fuck
shag	fuck
smeg	fuck
fi	fuck it
figmo	Fuck it - got my orders
fm	fuck me
fmbb	Fuck Me Baby
fmb	fuck me bitch
fmh	Fuck me hard
fckm3hdbayb	Fuck Me Hard Baby
fmhb	fuck me hard bitch
fmita	fuck me in the ass
fmltwia	fuck me like the whore I am
fmn	Fuck me now
fmnb	fuck me now bitch
fmnkml	fuck me now kiss me later
fmq	fuck me quick
fmr	fuck me runnig
fmth	fuck me to hell
fmuta	fuck me up the ass
fmutp	fuck me up the pussy
fmah	fuck my ass hole
fmbo	fuck my brains out
fmfl	Fuck my Fucking life
fmflth	Fuck My Fucking Life To Hell
f.m.l.	fuck my life
fml	fuck my life
fmph	fuck my pussy hard
f/o	fuck off
fo	fuck off
foad	fuck off and die
foa	fuck off asshole
foah	fuck off asshole
fomofo	fuck off mother fucker
foyb	fuck off you bitch
fouc	Fuck off you cunt 
ft	FUCK THAT
ftb	Fuck That Bitch
fts	fuck that shit
fa-q	Fuck you
fuh-q	fuck you
4q	fuck you
f u	fuck you
f.u.	fuck you
fcku	fuck you
fku	fuck you
fu	fuck you
fuq	fuck you
fy	fuck you
phq	fuck you
fua	fuck you all
fudie	fuck you and die
fyad	fuck you and die
fuah	fuck you ass hole
fyah	fuck you asshole
fubohic	fuck you Bend over here it comes
fub	fuck you bitch
fyb	fuck you bitch
fudh	fuck you dick head
fumfer	fuck you mother fucker
fyrb	fuck you right back
fut	Fuck You Too
fuu	fuck you up
fyc	fuck your couch
fyf	fuck your face
fym	fuck your mom
knn	fuck your mother
fus	fuck yourself
f00k	Fuck.
fckd	fucked
fuxored	Fucked
fiic	Fucked If I Care
fiik	Fucked If I Know
fubah	fucked up beyond all hope
fubalm	fucked up beyond all local maintenance
foobar	fucked up beyond all recognition
fubar	fucked up beyond all recognition
fubb	fucked up beyond belief
fubh	fucked up beyond hope
fubr	Fucked Up Beyond Recognition
4ker	fucker
fker	fucker
fukr	fucker
fuxor	fucker
phucker	fucker
ef-ing	fucking
f-ing	fucking
4king	fucking
effin	fucking
effing	Fucking
f#cking	Fucking
f'n	fucking
fckin	fucking
fcking	fucking
fkin	fucking
fking	Fucking
fkn	Fucking
fucken	Fucking
fukin	fucking
fukkin	fucking
fukn	fucking
fuxing	fucking
fg	fucking gay
fgi	fucking google it
fpos	fucking piece of shit
fucktard	fucking retard
fuctard	fucking retard
fsob	Fucking son of a bitch
fugly	fucking ugly
fos	full of shit
phun	fun
ftio	fun time is over
fnny	funny
fny	funny
funee	funny
funy	funny
fah	Funny as hell
gba	game boy advance
gngbng	gang bang
gangsta	gangster
gsta	Gangster
gigo	garbage in garbage out
g8	gate
g3y	gay
g@y	gay
gai	gay
gey	gay
ghei	Gay
ghey	gay
gy	gay
gah	gay ass homo
gemo	gay emo
gwm	gay white male
gow	gears of war
gaoep	generally accepted office etiquette principles
gt	get
gafl	get a fucking life
gaj	get a job
gal	get a life
gafi	get away from it
gafm	Get away from me
gcad	get cancer and die
gigig	get it got it good
gnn	get naked now
gnoc	get naked on cam
gnos	get naked on screen
gnrn	get naked right now
gomb	get off my back
goya	Get Off Your Ass
goyhh	get off your high horse
goc	get on camera
gotc	get on the computer
gooh	get out of here!
goomh	get out of my head
goml	get out of my life
goi	get over it 
goia	get over it already
gsp	get some pussy
gtf	get the fuck
gtfbtw	get the fuck back to work
gtfo	get the fuck out
gtfon	Get the fuck out noob
gtfooh	get the fuck out of here
gtfoomf	get the fuck out of my face
gtfoi	get the fuck over it
gtfuotb	get the fuck up out this bitch
gtho	get the hell out
gttp	get to the point
gws	get well soon
getcha	get you
gypo	Get Your Penis Out
gtn	getting
grtg	Getting ready to go
gsd	getting shit done
geto	ghetto
gol	giggle out loud
gmao	Giggling my ass off
gmfao	Giggling My Fucking Ass Off
gtm	giggling to myself
grl	girl
grrl	Girl
gurl	girl
gyal	girl
shawty	girl
gfe	Girl Friend experience
glu	girl like us
g/f	girlfriend
gf	girlfriend
gurlz	girls
giv	give
gimme	give me
gimmie	give me
gmabj	give me a blowjob
gmab	give me a break
gmafb	give me a fucking break
gmybs	give me your best shot
g2cu	glad to see you
gmod	Global Moderator
gsave	global struggle against violent extremists
g0	go
ga	go ahead
gagf	go and get fucked
gagp	go and get pissed
gaalma	go away and leave me alone
gb	Go back
gb2	go back to
gbtw	go back to work
gbioua	Go blow it out your ass
gdiaf	go die in a fire
gdih	Go die in hell
gfar2cu	go find a rock to crawl under
gfak	go fly a kite
gfadh	go fuck a dead horse
gfad	go fuck a duck
gfam	Go Fuck A Monkey
gfas	go fuck a sheep
gfo	go fuck off
gfyd	go fuck your dad
gfym	go fuck your mom
gfu	go fuck yourself
gfurs	go fuck yourself
gfus	go fuck yourself
gfys	go fuck yourself
gfgi	go fucking google it
ggal	go get a life
ggf	go get fucked
gjial	go jump in a lake
gky	Go kill yourself
gkys	Go kill yourself
gsfg	Go search fucking google
gosad	go suck a dick
gsad	go suck a dick
gsi	go suck it
gtas	go take a shit
gtfa	Go The Fuck Away
gtha	go the hell away
g2	go to
gtb	Go To Bed
gtfh	go to fucking hell
g2/-/	go to hell
g2h	go to hell
gth	go to hell
g2hb	go to hell bitch
gthb	go to hell bitch
gthmf	go to hell mothafucka
gthyfah	go to hell you fucking asshole
gwytose	go waste your time on someone else
gawd	god
gbu	god bless you
gdi	God Damn it
gdmfpos	god damn mother fucking piece of shit
gfd	god fucking damnit
gjsu	god just shut up
gok	God Only Knows
gork	God only really knows
gng	going
goin	going
gonna	going to
g2bl8	going to be late
gno	going to do
gts	going to school
gbnf	Gone but not forgotten 
gona	Gonna
gd	good
gewd	good
gud	good
gudd	good
gaf	good as fuck
gby	good bye
gdby	good bye
gday	Good Day
g4u	good for you
g4y	good for you
gd4u	Good For You
gfy	good for you
homie	good friend
gfg	good fucking game
gfi	good fucking idea
gfj	good fucking job
gg	good game
gga	good game all
ggnore	good game no rematch
ggs	good games
gdgd	good good
gh	good half
gj	good job
gjp	good job partner
gjt	good job team
gl	good luck
glux	good luck
gla	good luck all
gl&hf	good luck and have fun
glnhf	Good Luck and Have Fun
glhf	good luck have fun
glty	Good luck this year
glu2	good luck to you too
glwt	good luck with that
gm	good morning
gmtyt	good morning to you too
gnfpwlbn	good news for people who love bad news
g'nite	good night
g9	good night
gn	good night
gn8	good night
gnight	good night
gnite	good night
nn	good night
gnasd	good night and sweet dreams
gnstdltbbb	good night sleep tight don't let the bed bugs bite
g1	good one
gp	good point
gpwm	good point well made
gsoh	Good Sense of Humor
gtty	good talking to you
g2k	good to know
gtk	good to know
gtsy	good to see you
gw	good work
gwork	good work
gwrk	good work
cu	goodbye
cya	goodbye
byeas	good-bye
gnst	goodnight sleep tight
good9	goodnite
9009l3	Google
g00g13	Google
gcf	Google Click Fraud
gis	Google Image Search
gim	google instant messanger
giyf	google is your friend
gir	google it retard
g2gpc	got 2 go parents coming
glln	Got Laid Last Night
gmv	Got my vote
gokid	got observers - keep it decent
gotta	got to
g2bg	got to be going
g2e	got to eat
g/g	got to go
g2g	got to go
gtg	got to go
g2gb2wn	got to go back to work now
g2gb	got to go bye
gtgbb	got to go bye bye
g2ge	got to go eat
g2g4aw	got to go for a while
gtgfn	got to go for now
gtgmmiloms	got to go my mum is looking over my shoulder
g2gn	got to go now
gtgn	got to go now
g2gp	got to go pee
gtgp	got to go pee
g2gpp	got to go pee pee
gtgpp	got to go pee pee
g2gs	got to go sorry
gtgtpirio	got to go the price is right is on
gtgtb	got to go to bed
g2g2tb	got to go to the bathroom
g2g2w	got to go to work
gtgtwn	Got to go to work now
g2p	got to pee
gtp	Got to pee
gtr	Got to run
g2t2s	got to talk to someone
ggpaw	gotta go parents are watching
ggp	gotta go pee
gpb	gotta pee bad
gta	Grand Theft Auto
gdilf	Grandad I'd Like To Fuck
gma	grandma
gilf	Grandma I'd like to fuck
gmilf	grandmother i'd like to fuck
gaw	grandparents are watching
gui	graphical data interface
gfx	graphics
grfx	graphics
gr8	great
gr8t	great
gmta	great minds think alike
nade	grenade
*g*	grin
gfe2e	grinning from ear to ear
grvy	groovy
gded	grounded
gfl	grounded for life
glf	group looking for
gtfu	grow the fuck up
gthu	grow the heck up
gu	grow up
grmbl	grumble
gwijd	guess what i just did
gitar	guitar
gnr	Guns n' roses
hhok	Ha Ha Only Kidding
hax0red	hacked
h4x0r	hacker
h4xor	hacker
h4xr	hacker
h4xx0rz	hacker
h4xxor	hacker
ha>	hacker
hax0r	hacker
haxer	Hacker
haxor	hacker
haxxor	hacker
haxxzor	Hacker
haxz0r	Hacker
haxzor	hacker
xor	hacker
h4kz0r5	hackers
h4xrz	hackers
hax0rz	Hackers
haxors	hackers
haxorz	hackers
haxoring	hacking
h4x	Hacks
hax	Hacks
heh	haha
hl	Half-Life
hl2	Half-Life 2
h2	Halo 2
hammrd	hammered
hj	hand job
hoas	Hang on a second
crakalakin	happening
hppy	Happy
hpy	happy
hbd	happy birthday
hpybdy	happy birthday
hxc	hardcore
h8	hate
h8t	hate
h8te	hate
hait	hate
heyt	hate
hml	hate my life
h82sit	hate to say it
h8ed	hated
h80r	hater
h83r	hater
h8er	hater
h8r	hater
h8t0r	hater
h8t3r	hater
h8tr	hater
htr	hater
h8s	hates
h8red	Hatred
hav	have
hv	have
hve	have
hagd	have a good day
hagn	have a good night
hago	have a good one
hagl	have a great life
hags	have a great summer
hakas	have a kick ass summer
hf	have fun
hfwt	have fun with that
hswm	Have Sex With me
hafta	have to
h2gtb	have to go to the bathroom
havnt	haven't
hvnt	haven't
hcbt1	he could be the one
hlm	he loves me
hwmbo	he who must be obeyed
hwmnbn	he who must not be named
hbic	head bitch in charge
hmfic	head mother fucker in charge
hnic	head nigger in charge
hoh	head of household
hud	Heads Up Display
hs	headshot
ht	Heard Through
hght	height
hiet	height
4311	hell
7734	hell
hll	Hell
hfn	Hell fucking no
hiik	Hell If I Know
hy	hell yeah
7734	hello
ello	hello
elo	hello
hai	hello
heyy	hello
heyya	hello
hi2u	hello
hlo	hello
howdey	hello
hiya	hello 
re/rehi	hello again
rehi	hello again
hi2u2	hello to you too
ehlp	help
hlp	help
hdop	Help Delete Online Predators
hw/hw	help me with homework 
ere	here
hre	here
hwg	here we go
hwga	here we go again
hyg	here you go
hak	here's a kiss
ey	hey
h3y	hey
heya	hey
hwu	hey what's up
hu	Hey you
^5	high five
hpb	high ping bastard
hsd	high school dropout
hmu	Hit Me Up
hmul	Hit me up later
htc	hit the cell
hg	HockeyGod
304	hoe
hb4b	hoes before bros
hld	hold
hmb	hold me back
h.o	hold on
h/o	hold on
hldn	hold on
hldon	hold on
ho	hold on
h/u	hold up
hly	holy
hfsbm	holy fucking shit batman
hfs	holy fucking shit!
hhiadb	Holy Hole in a Donut Batman
hhiad	holy hole in a doughnut
hmoj	holy mother of jesus
hlysht	Holy shit
hom	home
h*r	homestar runner
hsr	homestar runner
h/w	homework
hmewrk	homework
hmw	homework
hmwk	homework
hmwrk	Homework
hw	homework
hwk	homework
h/mo	homo
homo	homosexual
hun	honey
hth	hope that helps
h2sys	hope to see you soon
hrny	horny
hlb	horny little bastard
hng	horny net geek
hss	horse shit and splinters
hawt	hot
hott	hot
hla	Hot lesbian action
hpoa	Hot Piece of Ass
hwms	hot wild monkey sex
hawtie	hottie
hr	hour
hrs	hours
han	how about now
habt	how about this
hbu	how about you
hby	how about you
hau	How Are You
hru	how are you
hayd	how are you doing
hrud	how are you doing
hbii	how big is it
hcihy	how can I help you
hcib	how can it be
hc	how come
hdu	how dare you
hdydt	how did you do that
hdydi	How do you do it
hhyb	how have you been
hith	how in the hell
hwz	how is
hoay	how old are you
hsik	how should i know
htf	how the fuck
hwik	how would i know
hyb	how you been
hyk	how you know
h/e	However
howz	hows
huggle	hug and cuddle
hugz	hugs
h&k	hugs and kisses
h+k	hugs and kisses
xox	hugs and kisses
xoxo	hugs and kisses
hngry	hungry
hb	hurry back
htfu	Hurry the fuck up
hubby	husband
hawf	Husband and Wife forever
h9	Husband in Room
hiw	husband is watching
http	hyper text transfer protocol
iawtc	I agree with this comment
iawtp	I agree with this post
iawy	I agree with you
3y3 y4m	I am
ima	I am a
imb	I am back
iab	I Am Bored
iafi	I am from India
iafh	I Am Fucking Hot
imh	I am here
iah	i am horny
iai	i am interested
ianabs	I am not a brain surgeon
ianacl	I am not a copyright lawyer
ianal	I am not a lawyer
ianars	I am not a rocket scientist
ians	I am Not Sure
inttwmf	I am Not Typing This With My Fingers
ianyl	I am not your lawyer
iap	I Am Pissed
iasb	i am so bored
imsb	i am so bored
imsry	I am sorry
iaspfm	i am sorry please forgive me
iatb	I am the best
im26c4u	I am too sexy for you
iavb	i am very bored
iym	I am your man
icgup	I can give you pleasure
icsrg	I can still reach Google
icb	I can't believe
icbi	i can't believe it
icbt	i can't believe that
icbu	I can't believe you
icbyst	i cant believe you said that
icr	I can't rememer
ictrn	I can't talk right now
icty	i can't tell you 
icw	I care why?
iccl	I could care less
iddi	I didn't do it
idkymb2	I didn't know yoru mom blogs too
idno	i do not know
idonno	i do not know
idunno	i do not know
idbtwdsat	I don't believe they would do such a thing
idby	I Don't Believe You
idc	I don't care
idec	I don't even care
idek	I don't even know
idfc	i don't fucking care
idfk	i don't fucking know
idfts	I don't fucking think so
idgi	I don't get it
idgac	i don't give a crap
idgad	I don't give a damn
idgaff	I don't give a flying fuck
idgaf	i don't give a fuck
idgafs	I don't give a fucking shit
idgara	I don't give a rat's ass
idgas	i don't give a shit
dernoe	I don't know
dunna	i don't know
dunno	I don't know
idk	I don't know
idn	i don't know
idnk	i don't know
ionno	I don't know
iono	I don't know
iunno	I don't know
idkbibt	I don't know but I've Been Told
idke	I don't know ethier
idkh	I don't know how
idkh2s	i don't know how to spell
idkt	I don't know that
idkwiwdwu	I don't know what I would do without you
idkwts	I don't know what to say
idkwurta	I don't know what you are talking about.
idkwym	I don't know what you mean
idkw	I don't know why
idkyb	i don't know why but
idky	I don't know you
idl	I don't like
idli	I don't like it
idlu	i don't like you
idly	I don't like you
idlyitw	i don't like you in that way
idm	I don't mind
bah	I don't really care
idrc	i don't really care
idrfk	I don't really fucking know
idrgaf	I don't really give a fuck
idrk	i don't really know
idrts	I don't really think so
idr	I don't remember
idsw	i don't see why
idtis	I don't think I should
idtkso	i don't think so
idts	i don't think so
iduwym	I don't understand what you mean.
idwk	I don't wanna know
idw2	I don't want to
idwt	i don't want to
idwtg	I don't want to go
idw2n	i don't want to know
iuno	i dunno
invu	I envy you
ifthtb	i find that hard to belive
ifwis	I forgot what I said
ifhu	I fucking hate you
ifhy	i fucking hate you
iflu	i fucking love you
ig5oi	I got 5 on it 
igt	I Got This
ig2g	I got to go
igtgt	I got to go tinkle
igyb	I Got Your Back
igg	i gotta go
ig	I guess
igs	I guess so
ih8	i hate
ihiwydt	I hate it when you do that
ihml	I hate my life
ih8mls	I hate my little sister 
ihmp	i hate my parents
ih8p	I hate parents
ihtfp	I hate this fucking place
ihtsm	i hate this so much
h8u	I Hate You
i8u	i hate you
iateu	i hate you
ih8tu	i hate you
ih8u	I hate you
ih8y	I hate you
ihat3u	I hate you
ihu	I hate you
ihy	i hate you
ihya	i hate you all
ihusb	i hate you so bad 
ihusfm	i hate you so fucking much
ih8usm	i hate you so much
ihusm	i hate you so much
ihysm	I hate you so much
ihysmrn	i hate you so much right now
ihurg	i hate your guts
ive	i have
ihac	I have a customer
ihnc	i have no clue
ihnfc	I have no fucking clue
ihni	i have no idea
ih2gp	I have to go pee
ihtp	I Have To Poop
ihtutbr	I have to use the bathroom
iht	I heard that
ihistr	i hope i spelled that right
ijcomk	i just came on my keyboard
ijdl	I just died laughing
ijdk	I just don't know
ijeomk	I just ejaculated on my keybord
ijf	i just farted
ijgl	I just got laid
ijpmp	I just peed my pants
ijpms	I just pissed myself
ijr	i just remembered
ijsabomomcibstg	I just saved a bunch of money on my car insurance by switching to geico
ikt	i knew that
ik	i know
ino	I know
iki	i know it
ikm	I know man
ikr	I know really
ikwym	i know what you mean
ikwum	I know what you meant
ikwyl	I know where you live
ilshipmp	I laughed so hard I peed my pants
iyq	I like you
ilyal	I like you a lot
ilhsm	i love him/her so much
ili	i love it
ilms	I love my self
iltf	i love to fuck
143	I love you
i <3 u	I love you
i<3 u	i love you
i<3u	I love you
ilu	I love you
iluvu	i love you
iluvya	i love you
ilvu	i love you
ily	i love you
iluaaf	i love you as a friend
ilyaas	I Love You As A Sister
ilybby	i love you baby
ilyb	i love you bitch
ilybtid	I Love You But Then I Don't
ily4e	i love you forever
ily4ev	i love you forever
ilygsm	i love you guys so much
ilykthnxbai	i love you k thanks bye
ilylabf	I love you like a best friend
ilylab	I love you like a brother
ilylafklc	i love you like a fat kid loves cake
ilulafklc	I love you like a fat kid loves cake.
ilylas	i love you like a sister
lylas	I love you like a sister
ilylc	i love you like crazy
ilyl	i love you loads
ilum	i love you more
ilym	i love you more
ilymtyk	i love you more than you know
ilymtylm	i love you more than you love me
ilusfm	I love you so fucking much
ilysfm	i love you so fucking much
ilysfmb	i love you so fucking much baby
ilusm	I love you So much
ilysm	i love you so much
ilysmih	i love you so much it hurts
ilysmm	i love you so much more
ilysmydek	I Love You So Much You Don't Even Know
ilysvm	i love you so very much
ilu2	I love you too
ily2	i love you too
iluvm	I Love You Very Much
ilyvm	i love you very much
iluwamh	i love you with all my heart
ilywamh	I love you with all my heart
imts	I meant to say
imy	I miss you
imu	i miss you 
imya	i miss you already
imysfm	i miss you so fucking much
imusm	I miss you so much
imy2	i miss you to
inh	I need help
inhwh	I need homework help
ind2p	I need to pee
intpftpotm	I nominate this post for the post of the month
iou	i owe you
irdc	I really don't care
irdgaf	i really don't give a fuck
irdk	I really don't know
irhy	i really hate you
irhtgttbr	I really have to go to the bathroom
irly	I really love you
i c	i see
ic	I see
icwudt	I see what you did there
iswydt	i see what you did there
icwum	I see what you mean
icu	i see you
icup	i see you pee
icic	I See. I See
istr	I seem to remember
isfly	i so fucking love you
isg	I speak geek
istwfn	I stole this word from noslang.com
isianmtu	I swear I am not making this up
is2g	i swear to god
itn	I think not
ityltk	I thought you'd like to know
ita	I Totally Agree
iwfusb	i wanna fuck you so bad
iws	i want sex
iwsn	i want sex now
iw2f	i want to fuck
iw2fu	i want to fuck you
iwfy	I want to fuck you
iwtfu	i want to fuck you
iwtfy	i want to fuck you
iwhswu	I want to have sex with you
iwthswy	i want to have sex with you
iwtly	i want to love you
iw2mu	I want to meet you
iwu	i want you
iwy	i want you
iwyn	I want you now
iwythmb	i want you to have my baby
iwyb	I want your body
iwjk	i was just kidding
iwbrbl@r	I will be right back later
iwfybo	i will fuck your brains out
iwlu4e	I will love you for ever
iwmu	i will miss you
iwmy	i will miss you
iwsul8r	I will see you later
iwuwh	i wish you were here 
iwhi	I would hit it
ilk2fku	I would like to fuck you
iwk	I wouldn't know
ioya	I'd Own Your Ass
eedyat	idiot
eejit	idiot
id10t	idiot
idjit	idiot
idot	idiot
idyat	idiot
ijit	idiot
ibcd	Idiot between chair & desk
iff	if and only if
iirc	if I recall correctly
iiuc	if I understand correctly
iistgtbtipi	If It Sounds Too Good To Be True It Probably Is
ioyk	if only you knew
iyam	if you ask me
iucmd	if you catch my drift
iydmma	if you don't mind me asking
iygm	if you get me
iukwim	if you know what i mean
iykwim	if you know what I mean
iyss	if you say so
iyswim	if you see what I mean
iywt	if you want to
iyflg	If You're Feeling Less Generous
ilbcnu	i'll be seeing you
ibt	I'll be there
ibw	I'll be waiting
ih2p	i'll have to pass
ilyf	I'll Love You Forever
irtf	I'll return the favor
ilcul8r	I'll see you later
tok2ul8r	i'll talk to you later
gamez	illegally obtained games
warez	illegally obtained software
ib	I'm back
imma	I'm going to
igtkya	im going to kick your ass
igkymfa	I'm gonna kick your mother fucking ass
imnl	I'm not laughing
ioh	I'm out of here
isb	I'm so bored.
iss	im so sorry
isbya	im sorry but you asked
iotd	image of the day
nayl	in a while
iaw	In Another Window
inb4	in before
ibtl	In Before The Lock
icudk	in case you didn't know
icydn	in case you didn't know
icymi	in case you missed it
icydk	in csae you didn't know
imao	in my arrogant opinion
imcdo	in my conceited dogmatic opinion
imfao	In My Fucking Arrogant Opinion
imfo	in my fucking opinion
inho	in my honest opinion
imhbco	In my humble but correct opinion
imhe	in my humble experience
imho	in my humble opinion
imnerho	In my not even remotely humble opinion
imnshmfo	In My Not So Humble Mother Fucking Opinion
imnsho	in my not so humble opinion
imo	in my opinion
imoo	in my own opinion
impo	In My Personal Opinion
impov	in my point of view
imvho	in my very humble opinion
iow	in other words
irl	in real life
irt	in reply to
iso	In Search Of
itc	in that case
itb	in the butt
itd	in the dark
itk	in the know
itt	in this thread
iwc	In Which Case
iyd	In Your Dreams
iyf	In your face
iyo	in your opinion
incrse	increase
indie	independent
ndn	indian
iois	Indicators of Interest
ij	indide joke
nub	inexperienced person
imwtk	Inquiring minds want to know
icp	insane clown posse
isj	inside joke
instagib	instant kill
instakill	instant kill
im	Instant Message
imm	instant message me
im'd	instant messaged
imed	instant messaged
intel	intelligence
ise	internal server error
inet	internet
intarwebs	internet
interweb	internet
ibs	Internet Bitch Slap 
ietf	internet engineering task force
ijp	Internet job posting
ip	internet protocol
irc	internet relay chat
isp	internet service provider
isd	internet slang dictionary
in2	into
n2	into
iz	is
tis	is
iiok	is it okay
iiw2	is it web 2.0?
enit	isn't it
init	isn't it
innit	isn't it
iebkac	issue exists between keyboard and chair
idop	it depends on price
iiwii	it is what it is
imtaw	it may take a while
iwaa	It was an accident
iwg	it was good
itz	it's
iag	it's all good
ijaf	it's just a fact
inbd	it's no big deal
inef	it's not even funny
inmp	it's not my problem
itzk	it's ok
sok	It's ok
iokiya	it's ok if you are
s'ok	it's okay
sokay	it's okay
uty	it's up to you
igahp	I've got a huge penis
igalboc	I've got a lovely bunch of cocnuts
igtg	i've got to go
qed	I've made my Point
irgtgbtw	I've really got to get back to work
j/o	jackoff
jb	jailbait
jyfihp	jam your finger in her pussy
jebus	Jesus
jfc	Jesus fucking Christ
bling-bling	jewelry
jtc	Join the club
jtfo	joke the fuck out
jks	jokes
jkz	jokes
jking	joking
jkn	joking
jooce	Juice
jfj	jump for joy
jst	just
jsut	just
jus	just
juss	just
juz	just
juzt	just
jas	just a second
jalaudlm	just as long as you don't leave me
j/a	Just Asking
jbu	just between us
jcam	just checking away message
j-c	just chilling
jcath	Just chilling at the house
j/c	just curious
jc	just curious
jeomk	Just ejaculated on my keyboard
jflts	just felt like typing something
jf	just fooling
j4f	just for fun
jff	just for fun
jfg	just for giggles
j4g	just for grins
j4l	just for laughs
jfl	just for laughs
jfn	just for now
jfr	Just for reference
jftr	just for the record
j4u	just for you
jfu	just for you
jfi	just forget it
jfo	just fuck off
jdfi	Just fucking do it
jfdi	Just Fucking Do It!
jfgi	just fucking google it
jfk	Just fucking kidding
jfwy	just fucking with you
jgtfooh	just get the fuck out of here
jg2h	just go to hell
jgiyn	Just google it you noob
jh	Just hanging
jho	just hanging out
jhm	just hold me
jic	just in case
jit	just in time
j/j	just joking
jj	just joking
jj/k	just joking
jja	just joking around
j/k	just kidding
jk	just kidding
jka	just kidding around
jklol	Just Kidding Laughing Out Loud
jkl	just kidding loser
jlma	just leave me alone
jlt	just like that
jms	just making sure
jm	Just Messing
jma	just messing around
jml	just my luck
jmo	just my opinion
jom	just one minuite
jooc	just out of curiosity
j/p	just playing
jp	just playing
j/s	just saying
js	just saying
jsing	just saying
jsuk	just so you know
jsun	Just so you know
jsyk	Just so you know
jsyn	just so you know
jsa	just stop already
j/t	just talking
jttsiowctw	just testing to see if other websites copy this word
jtay	just thinking about you
jtol	just thinking out loud
jtoi	just thought of it
jtumltk	just thought you might like to know
jtysk	just thought you should know
jtyltk	just thought you'd like to know
j2bs	just to be sure
jtbs	Just To Be Sure
j2luk	just to let you know
j2lyk	just to let you know
jtluk	just to let you know
jtlyk	just to let you know
jtty	just to tell you
j2c	just too cute
j2f	just too funny
jwas	just wait a second
jw2k	just wanted to know
jwtlyk	Just wanted to let you know
j/w	just wondering
jw	just wondering
kit	keep in touch
kic	keep it clean
kig	keep it going
kis	keep it simple
kiu	Keep it up
kots	keep on talking shit
kt	keep talking
kutgw	Keep Up The good Work
kyfc	keep your fingers crossed
kyko	keep your knickers on
kpc	keeping parents clueless
kfc	kentucky fried chicken
ka	Kick Ass
kaw	kick ass work
khitbash	kick her in the box and shove her
kmao	kick my ass off
kir	kid in room
kos	kid over shoulder
frag	kill
gank	kill
kafn	kill all fucking noobs
kiwf	Kill It With Fire
kmn	kill me now
kmp	kill me please
ks	kill steal
ktc	kill the cat
kys	kill yourself
fragged	killed
kiled	killed
kia	Killed In Action
kmsl	killing myself laughing
kmswl	killing myself with laughter
kb	KiloBite
kinda	kind of
kky	kinky
kss	kiss
mwah	kiss
snog	kiss
*4u	Kiss for you
kma	kiss my ass
kmag	kiss my ass goodbye
kmb	kiss my butt
kmfa	kiss my fucking ass
kmhba	kiss my hairy big ass
kol	kiss on lips
kotc	kiss on the cheek
kotl	kiss on the lips
kwtsds	Kiss where the sun don't shine
kyag	Kiss Your Ass Goodbye
kyfag	kiss your fucking ass goodbye
kssd	kissed
snogged	kissed
besos	kisses
kah	kisses and hugs
norwich	knickers off ready when I come home
kisa	knight in shining armor
kotor	Knights of the old republic
kitfo	knock it the fuck off
ko	knock out
ktfo	knocked the fuck out
kno	know
knw	know
noe	know
khuf	know how you feel
kwim	Know What I Mean
kwis	Know what I'm saying?
nowin	knowing
kkk	ku klux klan
lolngs	laghing out loud never gonna stop
lasb	Lame Ass Stupid Bitch
l4m3rz	lamers
lappy	Laptop
lpiaw	Large Penis is always welcome
lazer	laser
lazor	laser
lzer	laser
lifo	last in first out
ln	last name
lwn	last week's news
l8	late
l84skool	late for school
l8a	later
l8er	later
l8ers	Later
l8rz	later
l8s	later
l8t	later
l8ta	later
l8ter	later
l8tr	later
lata	later
lates	later
latr	Later
ltr	later
l8rs	laters
laff	laugh
lat	laugh at that
latn	laugh at the newbs
lau	laugh at you
lih	Laugh in head
limh	laugh in my head
liol	laugh insanely out loud
llf	laugh like fuck
lmaomtoaoa	Laugh my ass off many times over and over again
lmfbo	laugh my fucking butt off
lmmfas	laugh my mother fuckin ass off
lmvo	laugh my vagina off
lobfl	Laugh Out Bloody Fucking Loud
lofl	laugh out fucking loud
l0lz	laugh out loud
lolcano	laugh out loud
lolees	laugh out loud
lolerz	laugh out loud
lolocost	laugh out loud
lololz	laugh out loud
lolz	laugh out loud
lols	laugh out loud 
lollercoaster	laugh out loud (a lot)
lolaw	laugh out loud at work
lol@u	Laugh out loud at you
lolio	laugh out loud I own
lolm	laugh out loud man
lolq	laugh out loud quietly
lol2u	Laugh out loud to you
lorl	laugh out real loud
lorrl	laugh out really really loud
lqtm	Laugh quietly to myself
lshid	laugh so hard i die
ltmq	Laugh To Myself Quietly
lub	laugh under breath
lyao	laugh your ass off
lybo	laugh your butt off
lawl'd	laughed out loud
lawled	laughed out loud
lol'd	laughed out loud
lold	laughed out loud
lshismp	laughed so hard I shit my pants
lal	laughing a little
latwttb	laughing all the way to the bank
l@u	laughing at you
lbnr	laughing but not really
lbvs	laughing but very serious
lbo	laughing butt off 
lfnar	laughing for no aparent reason
lfr	Laughing for real
lhao	laughing her ass off
lirl	laughing in real life
liyf	laughing in your face
llab	Laughing like a bitch.
llc	laughing like crazy
lmty	laughing more than you
lmaowrotf	Laughing my ass of while rolling on the floor
lmao	laughing my ass off
lmaonade	laughing my ass off
lmaoxh	laughing my ass off extremely hard
lmaootf	Laughing my ass off on the floor 
lmaool	laughing my ass off out loud 
lmaorof	Laughing my Ass off Rolling on the floor
lmaorotf	laughing my ass off rolling on the floor
lmaowtntpm	laughing my ass off whilst trying not to piss myself
lmaol	laughing my ass out loud
lmbfwao	laughing my big fat white ass off
lmbao	laughing my black ass off
lmbo	laughing my butt off
lmcao	laughing my crazy ass off
lmclao	laughing my cute little ass off
lmfo	laughing my face off
lmfto	laughing my fuckin tits off
lmfao	laughing my fucking ass off
lmffo	Laughing my fucking face off
lmffao	laughing my fucking fat ass off
lmfho	laughing my fucking head off
lmfpo	laughing my fucking pussy off
lmgdao	Laughing My God Damn Ass Off
lmhao	laughing my hairy ass off
lmho	laughing my heiny off
lmmfao	laughing my mother fucking ass off
lmmfaos	laughing my mother fucking ass off silly
lmmffao	laughing my mother fucking fat ass off
lmoao	Laughing my Other Ass Off
lmpo	laughing my panties off
lmsao	laughing my sexy ass off
lmso	laughing my socks off
lmto	laughing my tits off
lof	Laughing on floor
lotf	laughing on the floor
loi	laughing on the inside
loti	laughing on the inside
kek	laughing out loud
lol	laughing out loud
lolin	laughing out loud
lollerskates	laughing out loud
loxen	laughing out loud
loxxen	laughing out loud
lolarotf	laughing out loud and rolling on the floor
lollam	Laughing Out Loud Like A Maniac
lolpimp	Laughing out loud peeing in my pants
lolrotf	laughing out loud rolling on the floor
lolrof	Laughing out loud while rolling on the floor.
lawls	laughing out loud with a southern drawl
lawlz	laughing out loud with a southern drawl
lolwtime	laughing out loud with tears in my eyes
lulz	Laughing out loud.
loomm	laughing out of my mind
lq	Laughing Quietly
lq2m	laughing quietly to myself
lqtms	Laughing quietly to myself
lqts	laughing quietly to self
lrfl	Laughing really fucking loud
lrh	laughing really hard
lrqtms	laughing really quietly to myself
lshipmp	Laughing so Hard I Piss My Pants
lshiwms	laughing so hard I wet myself
lshic	laughing so hard i'm crying
lshmson	laughing so hard milk shot out nose
lshrn	laughing so hard right now
lsmih	laughing so much it hurts
ltms	Laughing to my self
l2ms	laughing to myself
lttpot	laughing to the point of tears
lthtt	laughing too hard to type
steamloller	Laughing. Alot.
loln	laught out loud... not
ltip	laughting until I puke
lawl	lauging out loud with a southern drawl
ltp	Lay the pipe
loflmao	laying on floor laughing my ass off
ltw	Lead The Way
l2	learn to
l2p	learn to play
l2r	Learn to read
lam	leave a message
lma	leave me alone
lmamf	leave me alone mother fucker
lmap	leave me alone please
lmo	Leave Me One
lms	leave me some
lmtfa	leave me the fuck alone
legit	legitimate
lesbo	lesbian
lez	Lesbian
lezbean	lesbian
lezbo	lesbian
lezzzie	lesbian
lug	lesbian until graduation
lgb	lesbian/gay/bisexual
lsfw	Less Safe For Work
leme	let me
lemme	let me
lmgtfy	Let me Google that for you
lmg	let me guess
lmk	let me know
lmks	Let Me Know Soon
lmkwut	let me know what you think
lmtus	let me tell you something
lbh	let's be honest
lfl	let's fuck later
lgbnaf	lets get butt naked and fuck
lgot	let's go out tonight
lgs	let's go shopping!
lhs	lets have sex
lhsrn	let's have sex right now
lm4aq	Let's meet for a quickie.
lmfr	Lets Meet For Real
lmip	LETS MEET IN PERSON
lmirl	Let's meet in real life
lsudi	Lets see you do it
lvl	level
lmb	lick my balls
lmd	Lick My Dick
lmp	lick my pussy
lyf	life
lyfe	life
lpms	life pretty much sucks
leik	like
liek	like
lik	like
lk	like
lke	like
lyk	like
lyk3	like
lyke	like
lamf	like a motherfucker
lic	like i care
liec	like i even care
ligaff	like I give a flying fuck
ligafs	like I give a flying shit
ligas	like I give a shit
lim	Like it Matters
lomg	like oh my god
liekz	likes
lmtd	limited
lnk	Link
lgn	link goes nowhere
ltm	listen to me
l2m	listening to music
llol	literally laughing out loud
lil	little
lbr	little boy's room
lgr	little girls room
lgf	little green footballs
liv	live
larp	live action role-play
lj	live journal
llap	live long and prosper
lan	local area network
lt	long time
ltnc	Long time no see
ltns	long time no see
ltnt	long time no talk
ldr	Long-distance relationship
luk	look
liu	Look It Up
lwih	look what I have
lukin	looking
lf	looking for
lf2m	looking for 2 more
lfg	Looking for group
lfm	looking for mate
lf1m	Looking for one more
lfp	looking for pussy
ltb	looking to buy
lawd	lord
lotr	lord of the rings
lozer	loser
lsr	loser
luzar	Loser
lzr	loser
lalol	lots and lots of laughs
lolf	lots of love forever
<3	love
lov	love
luf	love
luff	Love
lurve	love
luv	love
luvv	love
lv	love
lve	Love
wub	love
wuv	love
lak	love and kisses
lafs	love at first sight
liita	love is in the air
lml	love my life
loml	love of my life
lomy	love of my life
ltywl	love the way you lie
lovu	love you
lvya	love you
ly	love you
lya	love you always
lyaab	Love you as a brother
lyaaf	Love you as a friend
lu4l	love you for life
lulab	Love you like a brother
lylab	love you like a brother
lylaba	love you like a brother always
lylad	love you like a dad
lylafklc	love you like a fat kid loves cake
lylam	love you like a mom
lulas	Love You Like a Sister
lylasa	love you like a sister always
lylno	Love you like no other
lul	love you lots
lyl	love you lots
lyls	love you lots
lymi	love you mean it
lysfm	love you so fucking much
lusm	love you so much
lysm	love you so much
ly2	love you to
lu2d	love you to death
lu2	love you too
lyt	love you too
luvuvm	love you very much
lyvm	love you very much
luver	lover
lvr	lover
lvn	loving
lcsnpc	low cost small notebook personal computer
lpb	low ping bastard
owned	made to look bad
ownt	made to look bad
pwn	made to look bad
pwned	made to look bad
msm	main stream media
miq	make it quick
mmd	make my day
p0wn	make to look bad
m.o	makeout
mml	making me laugh
mmw	making me wet
m4f	male for female
m4m	male for male
m/f	male or female
morf	male or female
msf	male seeking female
moobs	man boobs
mngmt	management
mngr	manager
myke	man-dyke
chronic	marijuana
reefer	marijuana
mflfs	married female looking for sex
mmlfs	married man looking for sex
mwf	Married White Female
marvy	marvelous
mmo	Massive Multiplayer Online
masterb8	masterbate
fapping	masterbating
fap	masturbate
mastrb8	masturbate.
wanker	masturbater
wanking	Masturbating
m8t	mate
mayte	mate
m84l	mate for life
m8s	mates
mtr	matter
mof	matter of fact
mtfbwu	may the force be with you
mtfbwy	May the Force be with you
m/b	maybe
mabby	maybe
mabe	Maybe
mayb	maybe
mbl8r	Maybe Later
mwsmirl	maybe we should meet in real life
mcds	mcdonalds
m3	me
meeh	me
msh	Me so horny
m2	me too
me2	me too
moh	Medal Of Honor
mohaa	Medal of Honor Allied Assult
mf2f4sx	meet face to face for sex
mirl	meet in real life
mmas	meet me after school
mmatc	meet me around the corner
mmamp	Meet me at my place
mmatp	meet me at the park
mml8r	meet me later
mmt	meet me there
mtg	Meeting
mlod	mega laugh out loud of doom
moss	member of same sex
motos	member of the opposite sex
mfg	merge from current
messg	message
msg	message
mssg	message
mmbocmb	message me back or comment me back
motd	message of the day
mrau	message received and understood
msgs	messages
msngr	messenger
grillz	metal teeth
mic	microphone
m$	Microsoft
mcse	Microsoft Certified Systems Engineer
msv	Microsoft Vista
m$wxp	Microsoft Windows XP
msie	microsoft's internet explorer
mlc	mid life crisis
mite	might
mph	miles per hour
myfb	mind your fucking business
myob	mind your own business
myodb	mind your own damn business
myofb	mind your own fucking business
m9	mine
myn	mine
min	minute
mins	minutes
misc.	miscellaneous
mu	miss you
myaly	miss you and love you
mul	miss you lots
musm	Miss You So Much
mysm	Miss you so much
m.i.a	Missing In Action
mia	Missing In Action
mk	mmm....ok
code 29	moderator is watching
mw2	modern warfare 2
mw3	Modern Warfare 3
m&d	mom and dad
miwnlf	mom I would not like to fuck.
milf	Mom i'd like to fuck
miltf	Mom I'd like to fuck
mir	mom in room
miw	mom is watching
mos	mom over shoulder
mompl	moment please
scrilla	money
msmd	monkey see - monkey do
mor	more
funner	more fun
mnt	More next time
mol	more or less
mpty	more power to you
motarded	more retarded
mtl	more than likely
mtc	more to come
mtf	More to Follow
mpbis	most popular boy in school
mpgis	most popular girl in school
mudda	mother
mutha	mother
muvva	mother
mofo	mother fucker
mtherfker	mother fucker
mthrfkr	mother fucker
mfa	mother fucking asshole
mfb	mother fucking bitch
mobo	motherboard
mf	motherfucker
mfkr	motherfucker
mfr	motherfucker
mtrfkr	motherfucker
mfah	motherfucking asshole
mpd	Multiple Personality Disorder
muve	multi-data virtual environment
187	murder
musiq	music
muzik	music
mah	my
mai	my
mao	my ass off
mb	my bad
mbf	my best friend
mbhsm	My Boobs Hurt So Much
mcs	My computer sucks
mego	my eyes glaze over
mfw	my face when
mfao	my fucking ass off
mgiwjsdchmw	my girlfriend is watching jeff so don't call her my wife
mhh	my head hurts
mho	My Humble Opinion
miid	my internet is down
mlia	my life is amazing
mmiw	my mom is watching
mmtyh	My mom thinks you're hot
mpaw	my parents are watching
mpih	my penis is hard
msibo	my side is busting open
mypl	my young padawan learner
miself	myself
myspce	myspace
nekkid	naked
nifoc	naked in front of computer
nifok	naked in front of keyboard
noc	naked on camera
np4np	naked pic for naked pic
nba	national basketball association 
ncaa	National Collegiate Athletic Association
noaa	National Oceanic and Atmospheric Administration
n8v	native
natch	naturally
n2n	need to know
ntk	Need to know
ntkb	need to know basis
n2p	need to pee
ntt	need to talk
nic	Network Interface Card
neva	never
nevah	never
nevar	Never
nevarz	never
nevr	never
nvr	never
nawidt	never again will i do that
nkt	never knew that
nevm	never mind
nvm	never mind
nvrmnd	never mind 
nvmdt	never mind then
n/m	nevermind
nvmd	nevermind
nvrm	Nevermind
nvmt	nevermind that
nu	new
nib	new in box
b00n	new person
noobie	new person
knewb	new player
newbie	new player
nooblet	new player
nyc	New York City
n00b	newbie
noobz0r	newbie
n00bs	newbies
n00s	news
nxt	next
ns	nice
ng	nice game
nh	nice hand
nj	Nice job
njp	nice job partner
nld	nice lay down
n1	nice one
ntty	nice talking to you
n2bb	nice to be back
ntmu	nice to meet you
ntmy	nice to meet you
nt	nice try
n/n	nickname
ni994	nigga
nizzle	nigger
9t	night
nite	night
n64	Nintendo 64
nes	Nintendo Entertainment System
nips	nipples
nah	no
naw	no
naww	no
noes	no
nbd	no big deal
n/c	no comment
ncs	no crap sherlock
ndit	No details in thread
nofi	No Flame Intended
nfc	no fucking clue
nfd	no fucking deal
nfi	no fucking idea
nfw	no fucking way
nft	no further text
ni	no idea
nin	no its not
nk	no kidding
nmw	no matter what
nmwh	no matter what happens
nnfaa	no need for an apology
nntr	no need to reply
nn2r	no need to respond
nntst	no need to say thanks
nnaa	no not at all
nnr	no not really
n/o	no offense
no1	no one
nolm	No one loves me
no pro	no problem
np	no problem
npgf	no problem girl friend
nph	no problem here
nps	No Problems
npi	no pun intended
nr	no reserve
nrn	No Response Necessary
nst	no school today
nsfu	no sex for you
nss	no shit sherlock
nsa	No Strings Attached
nsas	No Strings Attached Sex
nstaafl	No Such Thing As a Free Lunch
n/t	no text
ntxt	no text
ntbn	no text-back needed
noty	no thank you
nty	no thank you
nowai	No way
nw	no way
nwy	no way
nwrus	no way are your serious 
nwih	no way in hell
nbdy	nobody
ngaf	nobody gives a fuck
nif	non internet friend
ritjive	non virgin
noub	none of your business
noyb	none of your business
noygdb	none of your god damn business
npc	Non-playable character
npe	nope
nop	normal operating procedure
nafta	North American Free Trade Agreement
nawt	not
naft	Not A Fucking Thing
n/a	not applicable
na	not applicable
nafc	Not Appropriate for Children
na4w	not appropriate for work
nao	Not As Often
naa	not at all
namh	not at my house
nafkam	Not Away From Keyboard Any More
nb	not bad
nc	not cool
nfbsk	not for british school kids
nfr	not for real
nfs	not for sale
nff	not fucking fair
nf	not funny
nhatm	not here at the moment
nimby	not in my backyard
nm	not much
nmh	not much here
nmf	not my fault
nmfp	not my fucking problem
nmp	Not My Problem
nomw	not on my watch
npa	not paying attention
ntrly	Not Really
nr4u	not right for you
nsfw	not safe for work
ntstt	not safe to talk 
nsfmf	not so fast my friend
ntigaf	not that i give a fuck
nttawwt	Not that there is anything wrong with that
nttiawwt	Not that there is anything wrong with that.
ntb	not to bad
n2br	not to be rude
ntm	not to much
ntmk	Not to my knowledge
ntw	not to worry
n2b	not too bad
n2g	Not too good
n2m	not too much
n2mh	not too much here
n2mhjc	not too much here just chillin
n2mhbu	not too much how about you?
nws	not work safe
nyf	not your fault
nyp	not your problem
nts	note to self
notin	nothing
nthg	nothing
nthin	nothing
nthn	nothing
ntn	nothing
nuffin	nothing
nufin	nothing
nutin	nothing
nuttin	nothing
nip	nothing in particular
nmhwby	nothing much here what about you
nmhau	nothing much how about you
nmjb	nothing much just bored
nmjch	Nothing Much Just Chilling
nmjdhw	nothing much just doing homework
ntta	nothing to talk about 
nigysob	now I've got you son of a bitch
nwtf	now what the fuck
noodz	nude pictures
n00dz	nudes
nmbr	number
obj	Object
ocd	obsessive compulsive disorder
obv	obviously
obvi	obviously
occ	Occupation
ofc	of course
otc	off the chain
oftpc	off topic
ot	off topic
of10	often
oftn	often
o	Oh
odg	oh dear God
ofcol	oh for crying out loud
ogw	oh guess what
ohn	oh hell no
ohy	oh hell yeah
ohic	oh I see
oicic	oh i see i see
omdz	Oh My Days 
omdg	oh my dear god
omfsm	Oh My Flying Spaghetti Monster
omfwtg	Oh My Fuck What The God?
omfg	oh my fucking god
zomfg	oh my fucking god
omfgn	Oh my fucking god noob
omfgsh	Oh My Fucking Gosh
omfl	oh my fucking internet connection is slow
omfj	oh my fucking jesus
omg	oh my God
omgz	oh my God
omgzors	oh my god
pmg	oh my God
z'omg	Oh my God
z0mg	oh my god
zomg	Oh my God
zomgzorrz	oh my god
omgicfbi	Oh my god I can't fucking believe it
omgihv2p	oh my god i have to pee
omgih	Oh My God In Heaven
omgny	oh my god no way
omgroflmao	oh my god roll on the floor laughing my ass off
omgty	Oh my god thank you
omgyg2bk	oh my god you got to be kidding
omgukk	oh my god you killed kenny
omgykkyb	oh my god you killed kenny you bastards
omgf	oh my god...Fuck!
omg's	oh my god's
omgn	oh my goodness
omgosh	Oh my gosh
omgsh	oh my gosh
omgd	Oh my gosh dude
omgg	Oh my gosh girl
omhg	oh my hell god
omj	oh my jesus
ommfg	oh my mother fucking god
omy	oh my!
0noe	Oh No
ohnoez	Oh no
onoez	oh no
onoz	oh no
onud	oh no you didn't
onyd	oh no you didn't
oh noez	Oh no!
o rly	oh really
orly	Oh Really
orly	oh really?
osy	oh screw you
osifgt	oh shit i forgot
oh noes	oh shit!
oways	oh wow are you serious
o/y	oh yeah
oyr	Oh Yeah Right
oyid	oh yes i did
k	ok
kk	ok
mkay	ok
kthz	ok thanks
kthxbai	ok thanks bye!
kthxgb	ok thanks goodbye
kthxmn	Ok Thanks Man
m'kay	okay
mmmkay	okay
ok	okay
ktnx	Okay and Thanks
kkthnxbye	okay thanks bye
obgjfioyo	old but good job finding it on your own
ofn	Old Fucking News
oar	on a roll
oaw	on a website
omw	on my way
omwh	on my way home
omwts	on my way to school
oow	On our way
osd	On Screen Display
otfcu	on the floor cracking up
otfl	on the floor laughing
otflmao	On the floor laughing my ass off
otflmfao	On the floor laughing my fucking ass off
otflol	on the floor laughing out loud
otfp	on the fucking phone
oti	on the internet
otoh	on the other hand
otp	on the phone
otw	on the way
oyo	on your own
1nce	once
odtaa	one damn thing after another
olpc	One Laptop Per Child
omt	one more time
oomf	One of my followers
1sec	one second
retrotextual	One who is using out of date words and abbreviations while texting.
ownzer	one who makes others look bad
lurker	one who reads but doesn't reply
oll	online love
orpg	online role playing game
oiyd	Only In Your Dreams
osbutctt	only sad bastards use this crappy text talk
oibmpc	oops I broke my computer
oidia	oops i did it again
oyfe	Open Your Fucking Eyes
os	operating system
op	operator
obo	or best offer
oe	or else
oslt	or something like that
orlsx	oral sex
oj	orange juice
orgy	orgasm
og	original gangster
o.p.	Original Poster
obl	osama bin laden
code9	other people near by 
owt	Out
oftc	out for the count
oobl	out of breath laughing
oob	out of buisness
ooc	out of character
oohm	out of his/her mind
oom	Out of mana
oomm	out of my mind
ootb	out of the blue
ooo	out of the office
ooym	out of your mind
otl	out to lunch
ova	over
uber	over
o&o	over and out
oaoa	over and over again
od	over dose
otft	over the fucking top
ots	over the shoulder
ott	over the top
pwnage	Ownage
pwn3d	owned
pwnd	owned
pwnt	owned
ownzorz	Owned.
pwn3r	owner
pwner	owner
pwnzor	owner
ownz	owns
pwnz	owns
oed	oxford english dictionary
pg	page
pcbd	page cannot be displayed
pima	Pain in my ass
pimfa	pain in my fucking ass
pimha	Pain in my hairy ass
pita	pain in the ass
pitfa	Pain In The Fucking Ass
pmfji	Pardon me for jumping in
pas	parent at side
pbb	parent behind back
pbm	parent behind me
p911	parent emergency (parent near)
pirlos	parent in room looking over shoulder
pitr	parent in the room
piw	Parent is watching
pl	parent looking
plac	parent looking at computer
platcs	parent looking at the computer screen
ploms	parent looking over my shoulder
p.o.b.	Parent Over Back
pob	parent over back
pol	parent over looking
poms	parent over my shoulder
p.o.s	parent over shoulder
p.o.s.	parent over shoulder
pos	Parent Over Shoulder
p^s	parent over shoulder
posmbri	parent over shoulder might be reading it
psbms	parent standing by my side
psos	parent standing over sholder
pwos	parent was over sholder
pw	parent watching
pwob	Parent watching over back
pwoms	parent watching over my shoulder
pfos	parental figure over sholder
parnts	parents
pezzas	parents
rents	parents
rentz	parents
pach	parents are coming home
pachs	parents are coming home soon
pag	Parents Are Gone
code 8	parents are watching
code 9	Parents are watching
p@w	parents are watching
paw	parents are watching
prw	parents are watching
pah	parents at home
pcrs	Parents can read slang
pir	parents in room
pitrtul	parents in the room text you later
plams	parents looking at my screen
plom	parents looking over me
plomb	parents looking over my back
plos	Parents Looking Over Shoulder
poscs	parents over sholder change subject
pwcb	parents watching close by
pww	parents were watching
prty	party
plars	party like a rock star
ptbb	pass the barf bag
ptfo	passed the fuck out
p/w	password
pwd	password
pce	peace
pz	peace
phlr	peace hugs love respect
pb	peanut butter
pb&j	peanut butter and jelly
pbj	peanut butter and jelly
pihb	pee in his/her butt
pp	pee pee
p2p	peer to peer
p-nis	penis
dick	penis
p33n	penis
p3n0r	penis
p3n15	penis
p3n1s	penis
peanus	penis
pen0r	Penis
pen15	penis
penor	penis
pns	penis
pnus	penis
peeps	people
peoples	people
ppl	people
ppls	people
pplz	people
pcent	percent
prfct	perfect
prd	period
prsn	person
troll	person who diliberately stirs up trouble
pto	Personal Time Off 
perv	pervert
prvrt	pervert
pvt	pervert
4n	Phone
fone	phone
phreaker	phone hacker
ph#	phone number
p4p	pic for pic
pic	picture
flicks	pictures
piccies	Pictures
pics	pictures
pix	pictures
poc	Piece of crap
pae	Pimpin aint easy
pfy	pimply faced youth
potc	pirates of the caribbean
pmfsl	piss my fucking self laughing
pmpl	piss my pants laughing
pmsl	piss my self laughing
po	piss off
poq	Piss Off Quick
pmsfl	Pissed Myself Fucking Laughing
p/oed	pissed off
po'd	pissed off
poed	pissed off
pimpl	pissing in my pants laughing
pmo	pissing me off
pmp	pissing my pants
pml	pissing myself laughing
pots	Plain Old Telephone Service
pl8	plate
ps1	Play Station 1
ps2	Play Station 2
ps3	Play Station 3
plywm	play with me
pk	player kill
pker	player killer
pking	player killing
pvp	player versus player
psn	playstation netwok
psp	playstation portable
puh-leaze	Please
pl0x	please
ple's	please
pleaz	please
pleez	please
pleeze	please
pleze	please
pliz	please
plocks	please
plox	please
ploxxorz	please
pls	please
plse	please
plz	please
pbp	Please Be Patient
pco	please come over
pex	Please explain?
pfa	Please Find Attached
pfm	Please forgive me
pfo	please fuck off
phm	please help me
plma	please leave me alone 
plmk	please let me know
prp	please reply
pst	please send tell
plx	please/thanks
plzthx	please? Thanks
poi	point of interest
pov	point of view
pkemon	pokemon
5o	police
po po	police
popo	police
p00p	poop
pewp	poop
poo	poop
pr0n	porn
pr0nz	porn
prn	porn
pron	porn
prnoscrn	porn on screen
ppor	post proof or recant
pnbf	Potential new boy friend
pmita	pound me in the ass
pmitap	pound me in the ass prison
pwor	power
ptl	Praise the Lord
preggers	pregnant
prego	Pregnant
pt33n	preteen
pthc	preteen hardcore
purty	pretty
pdg	pretty damn good
pdq	pretty damn quick
phat	pretty hot and tasty
pyt	pretty young thing
prncss	princess
prncpl	principal
ppppppp	Prior Proper Planning Prevents Piss Poor Performance
pow	prisoner of war
prv	private
pbly	probably
probly	probably
probz	probably
prolly	Probably
prollz	probably
prblm	Problem
prob	problem
pbcakb	problem between chair and keyboard
pbkc	Problem between keyboard & chair
pebmac	Problem Exist Between monitor and chair
pebcak	Problem Exists Between Chair and Keyboard
pebkac	problem exists between keyboard and chair
prod	product
pr0	professional
pro	professional
pf	profile 
proxie	proxy
pda	public display of affection
psa	Public Service Announcement
pxr	punk rocker
bur	pussy
chut	pussy
pssy	pussy
pwb	pussy whipped bitch
pasii	put a sock in it
piihb	put it in her butt
piitb	put it in the butt
pydim	put your dick in me
pyfco	put your freaking clothes on
pzled	puzzled
qotsa	queens of the stone age
q33r	Queer
qna	question and answer
q4u	question for you
kwik	quick
qltm	quietly laughing to myself
kwit	quit
qpwd	quit posting while drunk
qpr	quite pathetic really
kwiz	quiz
qotd	quote of the day
qoty	quote of the year
qfe	quoted for emphasis
qfmft	quoted for motherfucking truth
qft	quoted for truth
qft&gj	quoted for truth and great justice
r8p	rape
r8pist	rapist
r8	rate
r8t	rate
ror	raughing out roud
rta	read the article
rtbq	Read The Blinking Question
rtfa	read the fucking article
rtffp	Read the fucking front page
rtfm	read the fucking manual
rtfmfm	read the fucking manual fucking moron
rtfmm	read the fucking manual moron
rtfp	read the fucking post
rtfq	Read The Fucking Question
rtfs	read the fucking summary
rtm	read the manual
rtr	Read the Rules
rdy	ready
rtfu	Ready the fuck up
r2f	Ready To Fuck
rtg	ready to go
rl	real life
rlbf	Real Life Boy Friend
rlf	Real Life Friend
rlgf	Real Life Girl Friend
rln	real life name
rq	real quick
rsn	real soon now
rlze	realize
rele	really
rlly	really
rly	really
rff	really fucking funny
rhgir	really hot guy in room
rlg	really loud giggle
rts	Real-time strategy
rcvd	received
ra2	red alert 2 (game)
ra3	Red Alert 3 (game)
rhcp	red hot chilli peppers
301ing	referring traffic to another site
rjct	reject
chillin	relaxing
rmr	remember
re	reply
rplbk	reply back
rtl	report the loss
pearoast	repost
reppin	representing
rino	republican in name only
rspct	respect
r.i.p.	rest in peace
rotw	rest of the world
rr	rest room
rrb	restroom break
r-tard	retard
rtard	retard
tard	retard
rtry	retry
roi	Return On Investment
rtf	return the favor
rwb	Rich White Bitch
rite	right
ryt	right
ryte	right
rb@u	right back at you
rbau	right back at you
rbay	right back at you
rbm	right behind me
rcsa	right click save as
rfn	right fucking now
rhs	right hand side
rawr	roar
rawk	Rock
roxor	rock
roxxor	rock
rmso	Rock My socks off
ro	rock out
rowyco	rock out with your cock out
rockr	rocker
r0x0rz	rocks
rawks	rocks
rcks	Rocks
rox	rocks
roxorz	rocks
rgr	roger
rpg	role playing game
rp	roleplay
roflmgdmfao	roling on floor laughing my god damn mother fucking ass off
rofalol	roll on the floor and laugh out loud
rotfalol	roll on the floor and laugh out loud
rotffl	roll on the fucking floor laughing
rotgl	roll on the ground laughing
rombl	rolled off my bed laughing
raoflmao	rolling around on floor laughing my ass off
ricl	rolling in chair laughing
rme	rolling my eyes
rofc	Rolling On Floor Crying
roffles	rolling on floor laughing
rofl&pmp	rolling on floor laughing and peeing my pants
roflastc	Rolling On Floor Laughing And Scaring The Cat
roflmaowpimp	rolling on floor laughing my ass off while peeing in my pants
roflmbfao	Rolling On Floor Laughing My Big Fat Ass Off 
roflmbo	rolling on floor laughing my butt off
roflmaouts	Rolling on floor laughing my fucking ass off unable to speak
roflmgo	Rolling On Floor Laughing My Guts Out
roflol	rolling on floor laughing out loud
roflmfaopmp	rolling on flor laughing my fucking ass of peeing my pants
rogl	rolling on ground laughing
roglmfao	rolling on ground laughing my fucking ass off
rotf	rolling on the floor
refl	rolling on the floor laughing
rifk	rolling on the floor laughing
roffle	rolling on the floor laughing
rofflecake	rolling on the floor laughing
rofl	rolling on the floor laughing
roflcopter	Rolling on the floor laughing
roofles	rolling on the floor laughing
rotfl	rolling on the floor laughing
rotflaviab	rolling on the floor laughing and vomiting in a bucket
roflkmd	rolling on the floor laughing kicking my dog
rofllh	rolling on the floor laughing like hell
rflmao	rolling on the floor laughing my ass off
roflao	rolling on the floor laughing my ass off
roflmao	rolling on the floor laughing my ass off
rotflmao	rolling on the floor laughing my ass off
roflmaoapimp	rolling on the floor laughing my ass off and peeing in my pants
rotflmaofaktd	Rolling on the floor laughing my ass off farted and killed the dog
roflmaool	Rolling on the floor laughing my ass off out loud
rotflmaool	rolling on the floor laughing my ass off out loud
rotflmfaopmp	rolling on the floor laughing my ass off pissin my pants
rotflmaostc	rolling on the floor laughing my ass off scaring the cat
rotflmbo	rolling on the floor laughing my butt off
rofflmfao	rolling on the floor laughing my fucking ass
roflmfao	rolling on the floor laughing my fucking ass off
rotflmfao	rolling on the floor laughing my fucking ass off
rotflmfaopimp	rolling on the floor laughing my fucking ass off peeing in my pants
roflmfaopimp	rolling on the floor laughing my fucking ass off pissing in my pants
rotflmfho	rolling on the floor laughing my fucking head off
roflmgao	rolling on the floor laughing my gay ass off
roflmgdao	rolling on the floor laughing my god damn ass off
roflmho	Rolling on the floor laughing my head off
rotflmho	rolling on the floor laughing my head off
roflmmfao	rolling on the floor laughing my mother fucking ass off
rotflmmfao	rolling on the floor laughing my mother fucking ass off
roflmiaha	Rolling on the floor laughing myself into a heart attack
roffle out loud	rolling on the floor laughing out loud
roffleol	rolling on the floor laughing out loud
rotflol	rolling on the floor laughing out loud
roflolbag	Rolling On The Floor Laughing Out Loud Busting A Gut
roflpmp	rolling on the floor laughing peeing my pants
roflpimp	rolling on the floor laughing pissing in my pants
roflwtime	Rolling on the Floor laughing with tears in my eyes
rotfpm	rolling on the floor pissing myself
rofpml	rolling on the floor pissing myself laughing
rofwl	Rolling on the floor while laughing
rotfwlmao	rolling on the floor while laughing my ass off
rofflecopters	rolling on the floor with laughter
rotfflmao	rolling on the fucking floor laughing my ass off
rotfflmfao	rolling on the fucking floor laughing my fucking ass off
rotg	rolling on the ground
rotglmao	rolling on the ground laughing my ass off
rolmao	Rolling Over Laughing My Ass Off
rolmfao	rolling over laughing my fucking ass off
rol	rolling over laugihng
rm	room
rihad	Rot In Hell And Die
rpita	royal pain in the ass
rpo	royally pissed off
rlz	rules
rsps	Runescape Private Server
sfe	safe
sfw	safe for work
sfwuz	safe for work until zoomed
soobs	saggy boobs
sed	said
sic	said in context
soc	Same old crap
sofs	same old fucking shit
sop	same old place
sos	same old shit
ssdp	same shit different pile
sssd	Same Shit Same Day
stsp	Same Time Same Place
stt	Same time tomorrow
s2u	same to you
snl	Saturday Night Live
syoa	Save Your Own Ass
sitmf	say it to my face
snm	say no more
sez	says
scurred	scared
sked	schedule
scool	school
skewl	school
skhool	school
skl	School
skool	school
skoul	school
skwl	school
siao	school is almost over
smho	Screaming My Head Off
sn	screen name
ss	screenshot
swafk	sealed with a friendly kiss
s.w.a.k.	sealed with a kiss
swak	sealed with a kiss
swalk	sealed with a loving kiss
srch	search
seo	Search Engine Optimization
serp	search engine results page
sgbadq	Search google before asking dumb questions
stfm	search the fucking manual
stfng	search the fucking news group
stfw	search the fucking web
sec	second
scrt	secret
ssl	secure sockets layer
c	see
shmily	see how much i love you
smb	see my blog
syrs	see ya real soon
cyu	see you
syatp	see you at the party
cu46	see you for sex
syiab	see you in a bit
syiaf	see you in a few
cuic	see you in class
cul	see you later
cul83r	See you later
cul8er	see you later
cul8r	See You Later
cul8tr	see you later
cyal	see you later
cyal8r	see you later
cyl	see you later
cyl8	see you later
cyl8er	see you later
l8r	see you later
sul	see you later
syl	see you later
syl8r	see you later
cuom	see you on monday
syotbf	see you on the battlefield
cyas	see you soon
sus	see you soon
sys	see you soon
syt	see you there
cyt	see you tomorrow
sut	see you tomorrow
cu2nit	see you tonight
cing	seeing
sellin	selling
jizz	semen
s2r	send to receive
s2a	sent to all
srs	serious
srly	seriously
srsly	seriously
srzly	seriously
srvis	Service
soa	service oriented architecture 
soe	service oriented enterprise
soi	service oriented infrastructure
svn	seven
53x	sex
cex	sex
nookie	sex
secks	sex
seks	sex
sexx0rz	sex
sx	sex
sxs	sex
zex	sex
sitb	sex in the but
sotr	sex on the road
syu	sex you up
s3x	Sex.
umfriend	sexual partner
std	sexually transmitted disease
6y	sexy
cexy	sexy
secksea	Sexy
secksy	sexy
sexc	sexy
sexe	sexy
sexi	Sexy
sexii	sexy
shexi	sexy
shexy	sexy
shmexy	sexy
smexy	sexy
sxc	sexy
sxcy	sexy
sxi	sexy
sxy	sexy
sah	sexy as hell
slf	sexy little fuck
smh	shaking my head
stw	share the wealth 
swmbo	she who must be obeyed
5h17	Shit
shiat	Shit
shiet	shit
shite	shit
shiz	shit
shizit	shit
shiznat	shit
shiznit	shit
shizz	shit
shizzle	shit
sht	shit
shyat	shit
shyt	shit
terd	shit
seg	Shit Eatin Grin
sh	shit happens
shtf	shit hits the fan
sool	shit out of luck
sol	Shit outta luck
shd	should
shld	should
shud	should
s/b	should be
siol	Shout It Out Loud
siuya	shove it up your ass
shwr	shower
showin	showing
sdf^	shut da fuck up
sfu	shut the fuck up
stfu	shut the fuck up
stfuppercut	shut the fuck up
stfua	shut the fuck up already
stfugbtw	shut the fuck up and get back to work
stfuah	shut the fuck up asshole
stfub	shut the fuck up bitch
stfuda	Shut the fuck up dumb ass
stfun	Shut the fuck up nigger
stfuogtfo	Shut the fuck up or get the fuck out.
stfuyb	shut the fuck up you bitch
stfuysoab	shut the fuck up you son of a bitch
sthu	shut the hell up
shuddup	Shut Up
shup	shut up
shut^	shut Up
su	shut up
suagooml	shut up and get out of my life
suib	shut up im busy
suyah	shut up you ass hole!
sydlm	Shut your dirty little mouth
syfm	shut your fucking mouth
sym	shut your mouth
sibir	sibling in room
s4se	Sight For Sore Eyes
sig	Signature
siggy	Signature
sbd	silent but deadly
swsw2b	single when she wants to be
swf	single white female
swm	single white male
sis	sister
sista	Sister
sfam	Sister from another mother
silf	Sister I'd Like To Fuck
stfd	sit the fuck down
sicl	sitting in chair laughing
simcl	sitting in my chair laughing
simclmao	sitting in my chair laughing my ass off
somadn	sitting on my ass doing nothing
snafu	situation normal all fucked up
snafubar	Situation Normal All Fucked Up Beyond Any Recognition
sk8	skate
s8ter	skater
sk8er	skater
sk8r	skater
sk8ter	skater
sk8tr	skater
sktr	skater
sk8ing	Skating
skillz	skills
slng	slang
sab	slap a bitch
slp	sleep
sleepin	sleeping
sleepn	sleeping
c-p	sleepy
sgtm	slightly gigling to myself
slo	slow
sl^t	Slut 
slore	slutty whore
smithwaws	Smack me in the head with a wooden spoon
*s*	smile
sof	smile on face
stm	smiling to myself
ss4l	smoking sista for life
kicks	sneakers
sqtm	snickering quietly to myself
soo	So
sbrd	so bored
sfsg	So far so good
sfh	So Fucking Hot
sfm	so fucking much
sfr	so fucking random
sfs	so fucking stupid
sfipmp	so funny I peed my pants
sg	so good
shrn	so hot right now
sl4n	so long for now
snf	so not fair
ssry	so sorry
sw	so what
sytycd	so you think you can dance 
sutuct	so you think you can type
sm	social media
sdk	Software Development Kit
sdlc	Software Development Life Cycle
0day	software illegally obtained before it was released
oday	software illegally obtained before it was released
smst	somebody missed snack time
sm1	someone
som1	someone
some1	someone
sum1	someone
slos	someone looking over shoulder
newb	someone who is new
noob	someone who is new
smthin	something
smthng	something
som'm	something
sth	something
sthing	something
sumfin	Something
summin	something
sumthin'	Something
sumtin	something
slt	something like that
smtm	sometime
s.o.a.b.	son of a bitch
s.o.b.	son of a bitch
sob	son of a bitch
soab	son of a btch
soafb	son of a fucking bitch
stb	soon to be
stbx	soon to be ex
sorreh	sorry
sowi	sorry
sowwy	sorry
soz	sorry
srry	sorry
sry	sorry
sz	sorry
sbc	sorry bout caps
sbt	sorry bout that
srynd2g	sorry need to go
swp	sorry wrong person
sorta	sort of
sk	spawn kill
spk	speak
sfy	speak for yourself
s2us	Speak to you soon
svu	special victims unit
sagn	Spelling and Grammar Nazi
sprm	sperm
sosg	spouse over shoulder gone
hijack	start an off topic discussion
st8	state
sahm	stay at home mom
s.i.t.	stay in touch
sofas	stepping out for a smoke
roids	steroids
sydim	stick your dick in me
smto	Sticking My Tongue Out
smtoay	Sticking my tongue out at you
sgi	Still got it
st1	stoned
sblai	stop babbaling like an idiot
st	Stop That
swmt	Stop Wasting My Time 
soml	story of my life
str8	straight
sxe	straight edge
sorg	Straight or Gay
str8up	straight up
sgb	straight/gay/bisexual
slgb	Straight/Lesbian/Gay/Bisexual
sbcg4ap	strongbads cool game for attractive people
stff	stuff
stoopid	stupid
stpd	stupid
stupd	stupid
stufu	stupid fucker
smofo	stupid mother fucker
smfpos	stupid mother fucking piece of shit
smf	stupid motherfucker
sotc	stupid off topic crap
spos	stupid peace of shit
ssob	stupid sons of bitches
see through your eyes	stye
ssia	subject says it all
sbs	such bull shit
suk	suck
sd	suck dick
siu	suck it up
smbd	suck my big dick 
smbt	Suck my big toe
smc	suck my cock
smd	suck my dick
smdb	suck my dick bitch
smdvq	suck my dick quickly
smfd	suck my fucking dick
smhb	suck my hairy balls
smt	suck my tits
sot	suck on this
suka	Sucker
sukz	sucks
sux	sucks
sux0rz	sucks
suxor	Sucks
suxors	sucks
suxorz	sucks
suxx	sucks
suxxor	sucks
s2bu	Sucks to be you
stby	sucks to be you
sux2bu	sucks to be you
supa	super
ub3r	super
snes	Super Nintendo Entertainment System
s'pose	suppose
supposably	Supposedly
sho	sure
shure	sure
sho'nuff	sure enough
stg	swear to god
swt	sweet
soad	system of a down
sysop	system operator
tt4n	ta ta for now
ttfn	ta ta for now
tkd	Tae Kwon Do
tc	take care
tcoy	take care of yourself
tiai	take it all in
tioli	take it or leave it
tmo	take me out
tma	take my advice
tmwfi	Take my word for it
tut	take your time
tyt	take your time
tyto	take your top off
tlk	talk
td2m	talk dirty to me
tdtm	Talk Dirty To Me
tl8r	talk later
t2m	talk to me
tlk2me	talk to me
ttm	talk to me
ttml	talk to me later
ttth	Talk To The Hand
tty	Talk to You
ttyab	Talk to you after breakfast
ttyad	Talk to you after Dinner
ttyal	Talk to you after lunch
ttyas	talk to you at school
ttyiam	talk to you in a minute
ttyitm	talk to you in the morning
t2ul	talk to you later
t2ul8r	talk to you later
tk2ul	talk to you later
tlk2ul8r	talk to you later
ttul	Talk To You Later
ttul8r	Talk to you later
ttyl	talk to you later
ttyl8r	talk to you later
ttylt	talk to you later today
ttyn	talk to you never
ttyna	talk to you never again
ttynl	talk to you never loser
ttynw	talk to you next week
ttyotp	talk to you on the phone
ttyo	talk to you online
ttyrs	talk to you really soon
ttus	talk to you soon
ttys	talk to you soon
ttyt	talk to you tomorrow
ttytm	talk to you tomorrow
ttywl	Talk to you way later
ttyw	talk to you whenever
twyl	Talk With You Later
twys	Talk With You Soon
tlkin	talking
tlkn	talking
totp	talking on the phone
ts	talking shit
ttms	talking to myself
t2u	talking to you
t8st	taste
tat2	tattoo
taunch	te amo un chingo
tiw	teacher is watching
tob	teacher over back
tw	Teacher Watching
taw	Teachers are Watching
te	Team effort
tf2	Team Fortress 2
tfc	Team Fortress Classic
tk	team kill
tker	team killer
tmnt	teenage mutant ninja turtles
tilf	Teenager I'd Like To Fuck
tv	television
tmai	tell me about it
tmbi	tell me about it
tmaai	tell me all about it
tml	tell me later
tmsg	tell me something good
tmsidk	tell me somthing I don't know
tmtt	tell me the truth
tswc	tell someone who cares
tlc	tender loving care
10tacle	Tentacle
tos	terms of service
tps	test procedure specification
txt	text
tb	text back
tmtmo	text me tomorrow
ttc	text the cell
tts	text to speech
txtyl	text you later
tyl	text you later
txting	texting
twi	Texting While Intoxicated
tfft	thank fuck for that
tg	thank god
tgft	thank god for that
tgfuap	thank god for unanswered prayers
tghig	thank god husband is gone
tgiwjo	Thank God It Was Just Once
tgif	thank god it's friday
tgiff	thank god its fucking Friday
tgis	thank god it's saturday
tgsttttptct	thank God someone took the time to put this crap together
tgwig	thank god wife is gone
10q	thank you
3q	thank you
3u	thank you
nq	Thank you
tanq	thank you
thankies	Thank You
thankx	thank you
thanq	thank you
thanx	thank you
thku	thank you
thx	thank you
thz	thank you
tku	thank you
tq	Thank You
tu	thank you
ty	thank you
tyfi	Thank You for invite
tyfn	thank you for nothing
tyfyc	Thank You For Your Comment
tyfyt	Thank you for your time
typ	thank you partner
tysfm	thank you so fucking much
tysm	thank you so much
tysvm	thank you so very much
tyty	thank you thank you
tuvm	thank you very much
tyvm	Thank You Very Much
tyvvm	thank you very very much
10x	thanks
thnx	thanks
thxx	thanks
tks	thanks
tnx	thanks
tnxz	thanks
tx	thanks
txs	thanks
tal	thanks a lot
ta	thanks again
tbnt	thanks but no thanks
t4a	thanks for asking
tfl	Thanks For Looking
tfs	thanks for sharing
tfta	thanks for the add
tfti	thanks for the information
tia	thanks in advance
tiafayh	Thanks in advance for all your help
tvm	thanks very much
tfln	thanx for last night
dat	that
taht	that
tat	that
th@	that
tht	that
tgws	that goes without saying
tifu	that is fucked up
tisc	that is so cool
tisfu	that is so fucked up
tisnf	that is so not fair
tisw	that is so wrong
ti2o	that is too obious
tms	that makes sense
tsig	that site is gay
twdah	that was dumb as hell
twf	That was funny
twg	That was great
tws2wa	That was so 2 weeks ago
twsy	That was so yeterday
twvsoy	that was very stupid of you
twbc	that would be cool
dats	that's
thatz	that's
taci	that's a crappy idea
tafn	That's all for now
taig	That's all I got. 
tfu	that's fucked up
tff	That's Fucking Funny
thwdi	thats how we do it
tjb	thats just boring
tmsaisti	That's my story and I'm sticking to it.
tnf	That's Not Funny
tok	That's ok
tsc	that's so cool
tsff	thats so fuckin funny
tsnf	that's so not fair
tss	That's so sweet
twfaf	thats what friends are for
twis	that's what I said
twss	That's what she said
da	the
t#3	the
t3h	the
teh	the
tha	the
tdwdtg	The Devil Went Down To Georgia
teotwawki	the end of the world as we know it
tfiik	the fuck if i know
tfa	the fucking article
tgfitw	The Greatest Fans In The World
thwy	the hell with you!
tiic	the idiots in control
tlgo	The list goes on
tmr@ia	the monkeys are at it again
tbp	The Pirate Bay
tpb	the pirate bay
tptb	the powers that be
meatspace	the real world
ussr	The Union of Soviet Socialist Republics
lolcity	the whole city laughs out loud
dem	them
em	them
thn	then
der	there
thar	there
thr	there
tanstaafl	there ain't no such thing as a free lunch
tinstaafl	There Is No Such Thing As A Free Lunch
thr4	therefore
deez	these
dey	they
tarfu	things are really fucked up
thnk	think
tai	think about it
tau	thinking about you
tay	thinking about you
tolol	thinking of laughing out loud
tofy	Thinking of You
tou	thinking of you
toya	thinking of you always
dis	this
tiatwtcc	this is a trap word to catch copiers
tif2m	this is fucking 2 much
tif	this is fun
tifs	this is funny shit
tinf	this is not fair
tinla	this is not legal advice
tisg	this is so gay
tiss	This is some shit
tliwwv	this link is worthless without video
tpiwwp	this post is worthless without pictures
ttiuwiop	this thread is useless without pics
ttiuwop	this thread is useless without pics
ttiuwp	This Thread Is Useless Without Pictures
ttiwwop	This thread is worthless without pics
ttiwwp	this thread is worthless without pics
whaletail	thong
tho	though
tla	Three Letter Acronym
thru	through
ttfaf	Through the Fire and Flames
tix	tickets
tigger	tiger
tddup	till death do us part
tym	time
tfb	time for bed
tfu2baw	time for you to buy a watch
t2b	time to blunt
ttr	time to run
trd	tired
tyred	tired
tna	tits and ass
tuh	to
2b	to be
tba	to be anounced
tbc	To be continued
tbd	to be decided
tbf	to be fair
tbfh	to be fucking honest
2bh	to be honest
tbh	to be honest
tbhimo	to be honest in my opinion
tbpfh	To be perfectly fucking honest
tbph	To be perfectly honest
tbqf	to be quite frank
tbqh	to be quite honest
tbvh	to be very honest
2g2b4g	To good to be forgotten
tlyk	to let you know
tl; dr	To Long; Didn't read
tmk	to my knowledge
rep	to represent
tttt	to tell the truth
ttutt	to tell you the truth
ttytt	to tell you the truth
2da	to the
ttbomk	to the best o fmy knowledge
2tm	to the max
ttt	to the top
2u2	To you too
2dae	today
2day	today
2ditd	today is the day
2ge4	Together
2gether	together
2gethr	together
2getr	Together
2getha	together 
tgfe	together forever
tp	toilet paper
tld	told
tys	Told You So
tomm	tommorow
2morrow	tommorrow
2m	tomorrow
2ma	Tomorrow
2maro	tomorrow
2mmrw	tomorrow
2mo	tomorrow
2mora	tomorrow
2moro	tomorrow
2morow	tomorrow
2morro	tomorrow
2moz	tomorrow
2mozz	tomorrow
2mro	tomorrow
2mrw	tomorrow
2mw	tomorrow
2mz	tomorrow
moro	tomorrow
tmmrw	tomorrow
tmoro	tomorrow
tmoz	tomorrow
tmr	tomorrow
tmrrw	tomorrow
tmrw	Tomorrow
tmrz	tomorrow
tmz	tomorrow
tomoz	tomorrow
tfic	Tongue Firmly In Cheek
2night	tonight
2nite	tonight
2nyt	tonight
2	too
2b4u	too bad for you
tb4u	too bad for you
tbfu	too bad for you
2bad4u2	too bad for you too 
tbss	too bad so sad
tcfc	Too Close For Comfort
tcfm	too cool for me
2qt	too cute
tdl	Too Damn Lazy
2ez	too easy
tfm	too fucking much
tffw	Too funny for words
tgfu	too good for you
2g2bt	too good to be true
tgtbt	Too Good To Be True
2h4u	too hot for you
2h2h	too hot to handle
2l8	too late
tltpr	Too long to proof read.
tl:dr	Too Long; Didn't Read
tl;dr	too long; didn't read
2m4u	too much for you
tmi	too much information
tmtoyh	Too Much Time On Your Hands
tmth	too much to handle
tmw	Too much work
2o4s	too old for sex
tstoac	too stupid to own a computer
2trd	too tired
tnlnsl	Took nothing left nothing signed log
totm	top of the morning
totpd	top of the page dance
tchbo	Topic creater has been owned
totl	total
ttl	total
tfd	total fucking disaster
2tali	totally
ttlly	totally
ttly	totally
tfbundy	totaly fucked but unfortunatly not dead yet
tuff	tough
tl	Tough Luck
tcg	Trading Card Game
trani	transexual
tranny	Transexual
xfer	transfer
t4m	Transgender for Male
trnsl8	translate
trnsltr	translator
tcp	transmission control protocol
tcp/ip	transmission control protocol/internet protocol
3arc	Treyarch
trble	trouble
tn1	trust no-one
t/a	Try again
tias	Try It And See
ttbc	Try to be cool
tthb	try to hurry back
ttihlic	try to imagine how little i care
2sday	tuesday
twttr	twitter
typo	typing mistake
toh	typing one handed
twoh	typing with one hand
ujds	u just did shit
ufab	ugly fat ass bitch
lofi	uncool
un4rtun8ly	unfortunately
upw	unidentified party wound
usd	United States Dollar
uaaaa	Universal Association Against Acronym Abuse
*67	unknown
ul	unlucky
ut	unreal tournament
ufic	Unsolicited Finger in Chili
ufia	unsolicited finger in the anus
upia	unsolicited pencil in anus
upcia	unsolicited pool cue in anus
til	until
u4i	up for it
u2u	up to you
uya	up your ass
uyab	up your ass bitch
u/l	upload
uayor	Use At Your Own Risk
utfs	Use the fucking search
utfse	use the fucking search engine
utw	used to work
uat	User Acceptance Testing
ua	data agreement
ui	User Interface
luser	data who is a loser
u/n	username
cunt	vagina
twat	vagina
v4g1n4	vagina
vag	vagina
vajayjay	vagina
vfm	value for money
vrsty	Varsity
vzn	verizon
vff	Verry Fucking Funny
hella	very
vry	very
vbeg	very big evil grin
vbg	very big grin
vf	very funny
vgg	very good game
vgh	Very good hand
vgl	very good looking
vip	very important person
vleo	Very Low Earth Orbit
vn	very nice
vnh	Very nice hand
sexilicious	Very Sexy
vwd	very well done
vweg	very wicked evil grin
vid	Video
vlog	video log
vids	Videos
vfe	Virgins 4 ever
vnc	Virtual Network Computing
vzit	visit
vb	visual basic
voip	voice over ip
w8	wait
wafm	wait a fucking minute
w8am	wait a minute
wam	wait a minute
w8t4me	wait for me
wuny	wait until next year
w8ter	waiter
w8ing	waiting
wlkd	walked
wnkr	wanker
wansta	wanna be ganster
wsb	wanna cyber?
wanafuk	wanna fuck
whf	Wanna have fun?
whs	wanna have sex
12b	wannabe
1ab	wannabe
wnt	want
wana	want to
wanna	want to
wna	want to
wtb	Want to buy
w2f	want to fuck
wgph2	Want to go play Halo 2?
wtgp	Want to go Private
w2ho	want to hang out
wtho	want to hang out?
wths	want to have sex
wthswm	want to have sex with me
w2m	want to meet
wts	want to sell
wan2tlk	Want to talk
wtt	want to trade
wttp	want to trade pictures?
wu2kilu	want you to know I love you
wc3	Warcraft III
woz	was
wuz	was
woft	Waste of fucking time
wogs	waste of good sperm
wochit	watch it
wylym	Watch Your Language Young Man
h2o	water
w2g	Way to go
wtg	way to go
wtgds	way to go dumb shit
wtmi	way too much information
wsf	we should fuck
wmd	Weapons Of Mass Destruction
blog	web log
blogger	web logger
webby	webcam
wcw	webcam whore
w33d	weed
wk	week
w/end	weekend
wkend	weekend
waf	weird as fuck
wrdo	weirdo
welc	welcome
wlc	welcome
wlcm	welcome
wb	welcome back
wlcb	welcome back
wbp	Welcome Back Partner
woc	welcome on cam
wtly	Welcome to last year
wd	well done
wtwr	well that was random
wybts	were you born this sexy
wat	what
wht	What
whut	what
wot	what
wut	what
wab	what a bitch
wafn	what a fucken noob
wafda	What a Fucking Dumb Ass
wafl	what a fucking loser
waloc	what a load of crap
walstib	what a long strange trip it's been
waw	what a whore
wau	what about you
wbu	what about you
wby	what about you
wai	what an idiot
watcha	what are you
whatcha	what are you
wutcha	What are you
wayd	what are you doing
wrud	what are you doing
wtrud	what are you doing
wyd	what are you doing
wayta	what are you talking about
wayt	What are you thinking?
wayut	what are you up to
wruu2	what are you up to
wau^2	what are you up to?
wauw	what are you wearing
wcutm	what can you tell me
wdim	What Did I miss
wdus	What Did You Say
wdys	What did you say
wdidn	what do i do now
wdwdn	what do we do now
whaddya	what do you
wduc	what do you care
wdye	What do you expect
wdum	what do you mean
wdym	what do you mean
wdyt	what do you think
wdutom	what do you think of me
wdut	what do you think?
wduwta	what do you wanna talk about
wduw	what do you want
wdyw	what do you want
wdywtd	what do you want to do
wdywd	what do you want to do?
wduwtta	what do you want to talk about
wdywtta	what do you want to talk about
wuwta	what do you want to talk about
wuwtab	what do you want to talk about
wuwtb	what do you want to talk about
wdtm	what does that mean
weve	what ever
whteva	what ever
wutevr	what ever
whubu2	what have you been up to
whubut	what have you been up to
whyd	What Have You Done
wiid	what if i did
witw	what in the world
witwwyt	what in the world were you thinking
waz	what is
wuts	what is
witfp	What is the fucking point
witwct	What is the world coming too
s'up	what is up
wiu	What is up?
wussup	What is up?
wiyp	what is your problem
wjwd	What Jesus Would Do
wntd	what not to do
woe	what on earth
wogge	what on god's green earth?
wswta	What shall we talk about?
wtbh	What the bloody hell
wtc	what the crap
wtcf	what the crazy fuck
wtd	what the deuce
wtf	what the fuck
wtfru	what the fuck are you
wtfayd	what the fuck are you doing
wtfrudng	what the fuck are you doing
wtfaud	what the fuck are you doing?
wtfrud	What the fuck are you doing?
wtfruo	what the fuck are you on?
wtfayta	What the Fuck are you talking about?
wtfruttd	what the fuck are you trying to do
wtfb	what the fuck bitch
wtfbs	What the fuck bull shit
wtfdik	what the fuck do i know
wtfdum	what the fuck do you mean
wtfdyw	what the fuck do you want
wtfduw	What the fuck do you want?
wtfe	What The Fuck Ever
wtfever	what the fuck ever
wtfigo	what the fuck is going on
wtfigoh	what the fuck is going on here
wtfit	what the fuck is that
wtfits	what the fuck is this shit
wtfiu	what the fuck is up
wtfiuwy	what the fuck is up with you
wtfiwwu	what the fuck is wrong with you
wtfiwwy	what the fuck is wrong with you
wtfiup	what the fuck is your problem
wtfiyp	what the fuck is your problem
wtfmf	what the fuck mother fucker
wtfo	what the fuck over
wtfwt	what the fuck was that
wtfwtd	what the fuck was that dude
wtfwtf	what the fuck was that for?
wtfwjd	what the fuck would jesus do
wtfuah	what the fuck you asshole
wtfya	what the fuck you asshole
wtfyb	what the fuck you bitch
wtful	What the fuck you loser
wtfg	What the fucking god
wtfh	what the fucking hell
wtfhb	what the fucking hell bitch
wtfhwt	what the fucking hell was that
wtfs	what the fucking shit?
wth	what the heck
wtharud	what the heck are you doing
wthayd	what the heck are you doing
wthaydwmgf	what the hell are you doing with my girlfriend
wthrud	what the hell are you doing?
wthauwf	what the hell are you waiting for
wthigo	what the hell is going on
wthiwwu	What the hell is wrong with you
wthwt	what the hell was that?
wthwut	what the hell were you thinking
wthyi	what the hell you idiot
wtmf	what the mother fuck
wtmfh	what the mother fucking hell
wtwm	what time are we meeting?
wtii	what time is it
wtiiot	What time is it over there?
w2d	what to do
wht^	what up
wuwu	what up with you
wwt	what was that
wwtf	what was that for
wwut	what were you thinking
wwcnd	What would Chuck Norris do
wwdhd	What would David Hasselhoff do
wwjd	what would jesus do?
wwudtm	what would you do to me
wwyd	what would you do?
wubu2	what you been up to
wubut	what you been up too
wudn	what you doing now
wula	what you looking at?
wym	What You Mean?
wysiayg	what you see is all you get
wysitwirl	what you see is totally worthless in real life
wysiwyg	what you see is what you get
wuu2	what you up to
wuut	what you up to
wuu22m	what you up to tomorrow
wuu2	what you up too
wuwtta	what you want to talk about
wha	what?
meh	whatever
w.e	Whatever
w.e.	whatever
w/e	whatever
w/eva	whatever
watev	whatever
watevr	whatever
watevs	whatever
wev	Whatever
wevr	whatever
whatev	whatever
whatevs	whatever
whever	whatever
whteve	whatever
whtever	whatever
whtevr	whatever
whtvr	whatever
wotevs	whatever
wtv	Whatever
wtva	whatever
wtvr	whatever
wudev	Whatever
wuteva	whatever
w\e	whatever
wateva	whatever 
wfyb	whatever floats your boat
wats	whats
wazz	what's
wfhw	what's for homework
wgo	what's going on
snew	what's new
wotv	What's on Television?
woum	what's on your mind
wtbd	what's the big deal
wtmtr	what's the matter
wat's^	Whats Up
wats ^	whats up
whats ^	whats up
sup	what's up
w'sup	what's up
wasup	What's Up
was^	What's Up
watz ^	What's up
waz ^	what's up
wazza	what's up
wu	what's up
wutup	What's Up
wuza	what's up
wuzup	what's up
wuwt	what's up with that
?up	what's up?
?^	what's up?
wad ^	what's up?
wadzup	What's up?
wassup	what's up?
wats^	what's up?
waz^	what's up?
what^	what's up?
wu	what's up?
zup	what's up?
wwwy	what's wrong with you
wyn	What's your name
wyp	what's your problem?
wen	when
wn	when
waycb	when are you coming back
wshtf	when shit hits the fan
wsibt	when should i be there
wwgf	when we gonna fuck
wwhw	when where how why
wwycm	when will you call me
wygac	when you get a chance
wygam	When you get a minute
whr	where
wru	where are you
wruf	where are you from
waug	Where are you going
wayn	Where Are You Now
?u@	Where are you?
wdwgw	where did we go wrong
whevah	where ever
whyb	where have you been
wthhyb	where the hell have you been?
wwy	where were you
wtp	where's the party
wrm	which reminds me
wywo	while you were out
waygow	who are you going out with
wc	who cares
wdyl	who do you like
wdytia	who do you think i am?
wgac	who gives a crap
wgaf	Who gives a fuck
wgas	who gives a shit
wgasa	who gives a shit anyway
witwu	who is there with you
wrgad	who really gives a damn
wrgaf	Who really gives a fuck?
wtfay	who the fuck are you
wtfc	Who The Fuck Cares
wthru	Who the heck are you
wthau	who the hell are you
wthay	who the hell are you
wwc	who would care
y	why
yrubm	why are you bugging me?
wayh	why are you here
yrusm	Why are you so mean
waysw	Why are you so weird
waysttm	why are you still talking to me
yru	why are you?
ycntu	Why Cant You?
ydufc	Why do fucking care?
wdydt	why do you do that
wdywtdt	Why Do You Want To Do That?
yduwtk	why do you want to know
wdhlm	why doesnt he love me?
yme	why me
yn	why not
ynt	why not
wnrn	why not right now
yoy	why oh why
wsi	why should I
ysic	why should I care
wsidi	Why Should I Do It
yswnt	why sleep when not tired?
yty	why thank you
ytf	why the fuck
wtfayt	why the fuck are you talking
ytfwudt	why the fuck would you do that?
wthdydt	why the hell did you do that
ythwudt	Why the hell would you do that
ywic	why would i care
wwikt	why would i know that
wyauimg	Why you all up in my grill?
yust	why you say that
wy	Why?
wkd	wicked
weg	wicked evil grin
wg	wicked gril
w911	Wife in room
wiw	wife is watching
wlos	wife looking over Shoulder
wl	will
wbb	will be back
wbbs	will be back soon
wbrb	Will be right back
wilco	will comply
wubmgf	Will You Be My Girlfriend?
wycm	Will You Call Me
wyc	will you come
wyg	will you go
wugowm	will you go out with me
wygwm	will you go with me
wypsu	will you please shut up
winnar	winner
wiwt	wish i was there 
wmgl	wish me good luck
wml	Wish Me Luck
wyatb	wish you all the best
wuwh	Wish you were here
wywh	wish you were here
w/	with
whit	with
wid	with
wif	With
wit	with
wiv	with
wadr	with all due respect
wamh	with all my heart
w/o	with out
wrt	with regard to
w/u	with you
witcha	with you
witu	with you
w/out	without
widout	without
wio	without
wad	without a doubt
meatcurtain	woman's private parts
1daful	wonderful
1dering	wondering
w00t	woohoo
woot	woohoo
zoot	woohoo
w012d	word
woa	word of advice
wotw	word of the week
wrk	work
wip	Work In progress
wfh	Working From Home
wmao	working my ass off
werkz	works
wfm	Works For Me
w.o.w	World of Warcraft
w.o.w.	world of warcraft
wsop	world series of poker
www	world wide web
wwe	World Wrestling Entertainment
wpe	worst president ever (Bush)
wdf	Worth Dying For
wrthls	Worthless
wld	would
wud	would
wuld	would
wbagnfarb	would be a good name for a rock band
wltm	would like to meet
wyhswm	would you have sex with me
wyhi	Would You Hit It?
wyltk	wouldn't you like to know
wowzers	wow
wyas	wow you are stupid
wys	wow you're stupid
w/b	write back
w.b.s.	Write Back Soon
wbs	write back soon
wrtg	writing
rong	wrong
wrng	wrong
wp	wrong person
xb36t	Xbox 360
xbl	xbox live
6flx	X-Rated movie
y!a	yahoo answers
yim	yahoo instant messenger
ya	yeah
ye	yeah
yea	yeah
yh	yeah
yarly	yeah really
yr	year
y2k	year 2000
yo	year old
ytd	year to date
yrbk	Yearbook
yrs	years
y/o	Years Old
mhm	Yes
yesh	yes
yup	yes
y/n	yes or no
yapa	yet another pointless acronym
ywud	yo whats up dude
j00	you
joo	you
u	you
y00	you
yew	you
yhew	you
yooh	you
yu	You
yuo	you
y'all	you all
yall	you all
ure	you are
ura	you are a
uraqt	you are a cutie
yaaf	you are a fag
urafb	you are a fucking bitch
yaafm	You Are A Fucking Moron
yaagf	you are a good friend
yaai	You are an idiot
urcrzy	you are crazy
urg	you are gay
yag	you are gay
url8	you are late
urnc	you are not cool
yaqw	You are quite welcome
ursdf	you are so damn fine
yasfg	you are so fucking gay
yasf	you are so funny
ursg	you are so gay
yasg	you are so gay
ursh	you are so hot
yrss	you are so sexy
urssb	you are so sexy baby
yasw	you are so weird
urstpid	you are stupid
urstu	you are stupid
yas	you are stupid
ursab	you are such a bitch
yrsaf	You Are Such A Fool 
yasan	You are such a nerd
urtb	you are the best
yatb	you are the best
urtbitw	You are the best in the world!
yatwl	you are the weakest link
urtw	you are the worst
ur2g	you are too good
uryyfm	you are too wise for me
urw	you are weird
uwc	you are welcome
yaw	you are welcome
ybya	you bet your ass
yctwuw	you can think what you want
uctaodnt	you can't teach an old dog new tricks
ycliu	You could look it up
udy	you done yet
udc	you don't care
udek	you don't even know
udwk	you don't want to know
ydpos	you dumb piece of shit
uds	you dumb shit
yfb	you fucking bastard
yfi	you fucking idiot
ufmf	you funny mother fucker
ugba	you gay bitch ass
ygg	you go girl
ygm	You Got Mail
ygp	you got punked!
ugtr	you got that right
ygtsr	you got that shit right
ygtbkm	you got to be kidding me
yhtbt	You Had To Be There
uhems	you hardly ever make sense
u'v	you have
uhab	you have a blog
yhpm	you have a private messge
yhf	you have failed
uvgtbsm	you have got to be shiting me
yhgtbsm	You Have Got To Be Shitting Me
yhl	you have lost
yhm	You have mail
u iz a 304	you is a hoe
yk	you kidding
yki	You know it
ykn	you know nothing
ukr	You know right
ykw	You Know What
ynw	you know what
ukwim	you know what i mean
ykwim	you know what I mean
ykwya	you know who you are
ykywywm	you know you wish you were me
ylb	you little bitch
ulbom	you looked better on myspace
ymmd	You Made My Day
ymislidi	you make it sound like i did it
ymbkm	you must be kidding me
un2bo	you need to back off
ynk	you never know
uom	You owe me
yomank	you owe me a new keyboard
upos	you piece of shit
upmo	You piss me off
ypmo	you piss me off
ypmf	you pissed me off
yrsm	you really scare me
urtrd	you retard
urms	you rock my socks
yrms	You Rock My Socks
ysm	you scare me
ysoab	You son of a bitch
ysf	you stupid fuck
yss	you stupid shit
usck	you suck
usuk	You Suck
usux	you suck
ys	you suck
ysa	You Suck Ass
ysal	you suck at life
ysati	you suck at the internet
uttm	you talking to me?
utm	you tell me
ytm	you tell me
ut	you there
yt	You there?
ytis	You think I'm special?
u2	You too
yua	you ugly ass
ywapom	you want a piece of me?
yws	you want sex
u'll	you will
ywywm	you wish you were me
u'd	you would
ybs	you'll be sorry
yng	young
youngin	young person
j00r	your
joor	your
ur	your
yo'	your
yor	your
yur	your
ybbg	Your Brother By Grace
ykisa	Your knight in shining armor
ymmv	your mileage may vary
ym	your mom
ymg2c	your mom goes to college
ymgtc	Your Mom Goes To college
ymiaw	your mom is a whore
ymfp	Your Most Favorite Person
yermom	your mother
ypom	your place or mine
ysitm	your shirt is too small
u'r	you're
yer	you're
uradrk	you're a dork
yaf	you're a fag
yafi	you're a fucking idiot
ydtm	You're dead to me
yfg	you're fucking gay
urht	you're hot
ykm	You're killing me
yqw	you're quite welcome
ur6c	you're sexy
yvfw	you're very fucking welcome
yvw	you're very welcome
uw	you're welcome
y w	you're welcome
yw	you're welcome
ywia	You're welcome in advance
ywvm	you're welcome very much
urs	yours
utube	youtube
y2b	Youtube
u've	You've
uve	You've
yhbt	you've been trolled
ygpm	you've got a private message
ygtbfkm	you've got to be fucking kidding me
ygtbk	you've got to be kidding
ygtbsm	You've got to be shitting me
zh	Zero Hour
zot	Zero Tolerance
zt	zoo tycoon
tru	TRUE
