14aa41	one for all and all for one
1nc	once
bday	birthday
alot	a lot
tho	though
4give	forgive
plz	please
wiv	with
lst	last
cud	could
fave	favourite
footie	football
wich	which
goin	going
wots	what's
msg	message
msgs	messages
talkin	talking
nthin	nothing
thru	through
cre8	create
dnd	do not disturb
2	to
whatcha	what are you
tht	that
lft	left
rite	right
osome	awesome
bx	box
uz	use
hpn	happen
answr	answer
prty	party
waitin	waiting
sendin	sending
havent	haven't
c'mon	come on
didnt	didn't
bod	body
sup	what's up
4got	forgot
feeln	feeling
wrld	world
mor	more
bk	back
hi2u2	hi to you too
u/l	you later
kiddin	kidding
yday	yesterday
tellin	telling
dont	don't
transl8r	translator
tues	tuesday
wedn	wednesday
orda	order
2b	to be
2bz4uqt	too busy for you cutey
2day	today
y-day	yesterday
2g2b4g	too good to be forgotten
2g2bt	too good to be true
2moro	tomorrow
2nite	tonight
hapnd	happened
hav	have
havnt	haven't
4	for
4eae	forever and ever
wan2meet	want to meet
4evr	forever
up2	up to
4evryrs	for ever yours
4gv	forgive
4nr	foreigner
a3	anytime anywhere anyplace
aaf	as a friend
aak	asleep at keyboard
aamof	as a matter of fact
aamoi	as a matter of interest
aar	at any rate
aas	alive and smiling
aatk	always at the keyboard
aayf	as always your friend
ab	ah bless
yrs	yours
bzy	busy
wer	were
shud	should
xx	kiss kiss
nxt	next
bbq	barbecue
dey	they
attn	attention
abithiwtidb	a bird in the hand is worth two in the bush
abt	about
nite	night
alredi	already
dun	done
dat	that
betta	better
gimme	give me
abt2	about to
ther	there
ace	access control entry
ack	acknowledgement
activ8	activate
adad	another day another dollar
adbb	all done bye bye
adctd2luv	addicted to love
addr	address
adih	another day in hell
adip	another day in paradise
adn	any day now
aeap	as early as possible
afagay	a friend as good as you
afahmasp	a fool and his money are soon parted
afaic	as far as i'm concerned
afaics	as far as i can see
afaict	as far as i can tell
afaik	as far as i know
afaiu	as far as i understand
afaiui	as far as i understand it
afap	as far as possible
afayc	as far as you're concerned
afc	away from computer
afiaa	as far as i am aware
afiniafi	a friend in need is a friend indeed
afk	away from keyboard
afpoe	a fresh pair of eyes
afz	acronym free zone
agkwe	and god knows what else
aight	alright
aih	as it happens
aimb	as i mentioned before
aimp	always in my prayers
aisb	as i said before
aise	as i said earlier
aisi	as i see it
aka	also known as
alap	as late as possible
alcon	all concerned
alig8r	alligator
aliwanisu	all i want is you
alol	actually laughing out loud
alotbsol	always look on the bright side of life
altg	act locally think globally
alwz	always
amap	as many as possible
ambw	all my best wishes
aml	all my love
amrmtyfts	all my roommates thank you for the show
anfscd	and now for something completely different
aoas	all of a sudden
aob	abuse of bandwidth
aon	apropos of nothing
ap	apple pie
asap	as soon as possible
asl	age sex location
atb	all the best
atk	at the keyboard
atm	at the moment
atst	at the same time
atw	at the weekend
awgthtgtta	are we going to have to go through this again
awhfy	are we having fun yet
awol	absent without leave
ax	across
ayc	aren't you clever
ayce	all you can eat
ayk	as you know
ayor	at your own risk
aypi	and your point is
aysos	are you stupid or something
aytmtb	and you're telling me this because
b	be
b2	back to
b2b	business to business
b4	before
b4u	before you
b4yki	before you know it
bak	back at keyboard
bau	business as usual
bb	be back
bb4n	bye-bye for now
bbb	bye bye babe
bbbg	bye bye be good
bbfn	bye bye for now
bbiab	be back in a bit
bbiaf	be back in a few
bbiam	be back in a minute
bbias	be back in a second
bbiaw	be back in a while
bbl	be back later
bbn	bye bye now
bbs	be back soon
bbsd	be back soon darling
bbsl	be back sooner or later
bbt	be back tomorrow
bcame	became
bcbc	beggars can't be choosers
bcbs	big company	 big school
bcnu	be seeing you
bcum	become
bd	big deal
bf	boyfriend
bfftte	best friends forever till the end
bfn	bye for now
bfz4evr	best friends forever
bg	big grin
bgwm	be gentle with me
bhg	big hearted guy
bhl8	be home late
bibi	bye bye
bibo	beer in beer out
bif	before i forget
bil	boss is listening
bion	believe it or not
bitd	back in the day
bka	better known as
bl	belly laughing
bm	byte me
bmgwl	busting my gut with laughter
bn	been
bndn	been nowhere done nothing
bnf	big name fan
bng	being
boctaae	but of course there are always exceptions
bol	best of luck
botoh	but on the other hand
bplm	big person little mind
br	bathroom
brb	be right back
bro	brother
brt	be right there
bsaaw	big smile and a wink
bsf	but seriously folks
bta	but then again
btdt	been there done that
btdtgts	been there	 done that	 got the t-shirt
bthoom	beats the heck out of me
btobs	be there or be square
btr	better
bttt	back to the top
btw	by the way
btwbo	be there with bells on
bw	best wishes
bwd	backward
bwdik	but what do i know
bwl	bursting with laughter
bwo	black white or other
bykt	but you knew that
c	see
c4n	ciao for now
caac	cool as a cucumber
cb	coffee break
cbb	can't be bothered
ceo	chief executive
cfv	call for vote
chln	chilling
chlout	chill out
chlya	chill ya
cico	coffee in coffee out
cid	consider it done
cm	call me
cmb	call me back
cmf	count my fingers
cmiw	correct me if i'm wrong
cmon	come on
cn	can
cnc	cheap and cheerful
cnp	continued in next post
cnt	can't
cob	close of business
cos	because
cr8	create
crat	can't remember a thing
crb	come right back
crbt	crying really big tears
crcdl	crocodile
crt	come round tonight
csg	chuckle snicker grin
csl	can't stop laughing
csthnknau	can't stop thinking about you
c-t	city
cta	call to action
cu	see you
cu2moro	see you tomorrow
cu2nite	see you tonight
cuatu	see you around the universe
cub	call you back
cubl8r	call you back later
cuimd	see you in my dreams
cul8r	see you later
cuns	see you in school
cunvr	see you never
cupl	couple
cw2cu	can't wait to see you
cwot	complete waste of time
cwyl	chat with you later
cy	calm yourself
cya	see ya
cym	check your mail
cyo	see you online
cyrbos	call your boss
czin	season
d	the
d8	date
d8ing	dating
damhikt	don't ask me how i know that
darfc	ducking and running for cover
db8	debate
dba	doing business as
dbeyr	don't believe everything you read
ddd	direct distance dial
deti	don't even think it
df	dear friend
dga	don't go anywhere
dgt	don't go there
dgtg	don't go there girlfriend
dgyf	damn girl you're fine
dh	dear hubby
dhyb	don't hold your breath
dict8	dictate
diku	do i know you
dilligad	do i look like i give a damn
dinr	dinner
ditr	dancing in the rain
dityid	did i tell you i'm distressed
diy	do it yourself
dk	don't know
dkdc	don't know don't care
dl	download
dltm	don't lie to me
dmi	don't mention it
dnc	does not compute
doe	depends on experience
doin	doing
dom	dirty old man
dp	domestic partner
dqmot	don't quote me on this
dqydj	don't quit your day job
drib	don't read if busy
dtrt	do the right thing
dui	driving under the influence
dur	do you remember
dv8	deviate
dwb	don't write back
dwbh	don't worry be happy
dwi	driving while intoxicated
dws	driving while stupid
dwwwi	surfing the world wide web while intoxicated
dwym	does what you mean
dxnre	dictionary
dyfm	dude you fascinate me
dyhab	do you have a boyfriend
dyhag	do you have a girlfriend
dyjhiw	don't you just hate it when
dyk	do you know
e123	easy as one two three
e2eg	ear to ear grin
eak	eating at keyboard
eft	electronic funds transfer
eg	evil grin
el	evil laugh
ema	e-mail address
emfbi	excuse me for butting in
emi	excuse my ignorance
eml	email me later
emsg	email message
eod	end of discussion
eol	end of lecture
eom	end of message
eopo	end of part one
eot	end of thread
esemed	every second every minute every day
eso	equipment smarter than operator
eta	estimated time of arrival
evry1	everyone
ewi	e-mailing while intoxicated
ezy	easy
f	friends
f2f	face to face
f2t	free to talk
f9	fine
faq	frequently asked questions
fawc	for anyone who cares
fbks	failure between keyboard and seat
fbm	fine by me
fc	fingers crossed
fe	fatal error
ff	friends forever
ficcl	frankly i couldn't care less
fitb	fill in the blank
fmtyewtk	far more than you ever wanted to know
foaf	friend of a friend
foc	free of charge
fofl	falling on floor laughing
fomcl	falling off my chair laughing
fone	phone
fotcl	falling off the chair laughing
fsr	for some reason
fst	fast
ftac	fantasy
ftasb	faster than a speeding bullet
ftbl	football
ftbomh	from the bottom of my heart
ftl	faster than light
ftlog	for the love of god
ftr	for the record
fttb	for the time being
ftw	for the win
fune	funny
fwd	forward
fwiw	for what it's worth
fya	for your amusement
fye	for your edification
fyeo	for your eyes only
fyi	for your information
fyltge	from your lips to gods ears
fym	for your misinformation
fysbigtbabn	fasten your seatbelts it's going to be a bumpy night
g	grin
g2cu	good to see you
g2g	got to go
g9	genius
ga	go ahead
gainty	get away i'm not telling you
gal	get a life
galgal	give a little get a little
galher	get a load of her
galhim	get a load of him
gbg	great big grin
gbh	great big hug
gd	good
gdi	god damn it
gf	girlfriend
gfi	go for it
gfn	gone for now
gftd	gone for the day
gg	good game
ggfn	got to go for now
ggn	gotta go now
ggp	gotta go pee
gigo	garbage in garbage out
giwist	gee i wish i'd said that
gizza	give us a
gj	good job
gl	good luck
glg	good looking girl
glyasdi	god loves you and so do i
gm	good move
gmab	give me a break
gmbo	giggling my butt off
gmesumluvin	give me some loving
gmta	great minds think alike
gmtft	great minds think for themselves
gnblfy	got nothing but love for you
gnr8	generate
gnr8n	generation
gnrle	generally
gnsd	good night sweet dreams
goi	get over it
gok	god only knows
gowi	get on with it
goyhh	get off your high horse
gr8	great
gratz	congratulations
grovbab	groovy baby
gsoas	go sit on a snake
gsoh	good sense of humour
gt	good try
gtgb	got to go	 bye
gtgp	got to go pee
gth	go to hell
gtm	giggle to myself
gtrm	going to read mail
gtsy	glad to see you
gws	get well soon
h2cus	hope to see you soon
h8	hate
habu	have a better un
hag1	have a good one
hagd	have a great day
hagn	have a good night
hagu	have a good un
hak	hugs and kisses
hamrd	hammered
hawtlw	hello and welcome to last week
hb	hurry back
hbib	hot but inappropriate boy
hbtu	happy birthday to you
hdepiyluv	how deep is your love
hf	have fun
hhis	hanging head in shame
hhoj	ha ha only joking
hhok	ha ha	 only kidding
hhos	ha ha	 only being serious
hhtyay	happy holidays to you and yours
hig	how's it going
hih	hope it helps
hiooc	help i'm out of coffee
hitaks	hang in there and keep smiling
hldmecls	hold me close
hnti	how nice that is
hntw	how nice that was
hohil	head over heels in love
hotluv	hot love
hotx3	hot hot hot
howru	how are you
hsik	how should i know
ht	hi there
ht4u	hot for you
hth	hope this helps
htnoth	hit the nail on the head
hua	heads up ace
hugz	hugs
humr	humour
hv	have
hw	how
hwga	here we go again
hwk	homework
iac	in any case
iad8	it's a date
iae	in any event
iaits	it's all in the subject
ianac	i am not a crook
ianae	i am not an expert
ianal	i'm not a lawyer but
iasap4u	i always say a prayer for you
iat	i am tired
iaw	i agree with
iawu	i agree with you
ibiwisi	i'll believe it when i see it
ibrb	i will be right back
ibt	in between technology
ibtd	i beg to differ
ibtl	in before the lock
ic	i see
icbw	i could be wrong
iccl	i couldn't care less
icq	i seek you
icwum	i see what you mean
id10t	idiot
idc	i don't care
idgi	i don't get it
idk	i don't know
idkiukb	i don't know if you know but
idky	i don't know you
i-d-l	ideal
idlu	i don't like you
idm	it does not matter
idst	i didn't say that
idts	i don't think so
idtt	i'll drink to that
ifab	i found a bug
igotubabe	i've got you babe
igtp	i get the point
ih8u	i hate you
iha	i hate acronyms
ihaim	i have another instant message
ihno	i have no opinion
ihu	i hear you
iiio	intel inside	 idiot outside
iimad	if it makes any difference
iir	if i remember
iirc	if i remember correctly
iitywimwybmad	if i tell you what it means will you buy me a drink
iitywybmad	if i tell you will you buy me a drink
iiwm	if it were me
ijc2sailuvu	i just called to say i love you
ijwtk	i just want to know
ikaloplt	i know a lot of people like that
ilu	i love you
iluvu2	i love you too
iluvumed	i love you more each day
im	i am
imao	in my arrogant opinion
imbluv	it must be love
imco	in my considered opinion
imhbco	in my humble but correct opinion
imheiuo	in my high exalted informed unassailable opinion
imho	in my humble opinion
imi	i mean it
imnsho	in my not so humble opinion
imo	in my opinion
imoo	in my own opinion
imprs	impress
ims	i am sorry
imtng	i am in a meeting
inmp	it's not my problem
innw	if not now	 when
inpo	in no particular order
ioh	i'm outta here
iohis4u	i only have eyes for you
iou	i owe you
ioud	inside	 outside	 upside down
iounotn	i owe you nothing
iow	in other words
iowan2bwu	i only want to be with you
irl	in real life
isagn	i see a great need
ish	insert sarcasm here
iss	i said so
istm	it seems to me
istr	i seem to remember
isyals	i'll send you a letter soon
itigbs	i think i'm gonna be sick
itm	in the money
itufir	i think you'll find i'm right
ium	if you must
iuss	if you say so
iwalu	i will always love you
iwanu	i want you
iyd	in your dreams
iydkidkwd	if you don't know i don't know who does
iykwim	if you know what i mean
iykwimaityd	if you know what i mean and i think you do
iyo	in your opinion
iyq	i like you
iyswim	if you see what i mean
j2lyk	just to let you know
j4f	just for fun
j4g	just for grins
j5m	just five minutes
jad	just another day
jas	just a second
jdi	just do it
jic	just in case
jk	just kidding
jmo	just my opinion
joott	just one of those things
jstcllme	just call me
jsu	just shut up
jt	just teasing
juadlam	jumping up and down like a monkey
k	ok
kbd	keyboard
kc	keep cool
kewl	cool
kfy	kiss for you
khyf	know how you feel
kia	killed in action
kir	keep it real
kit	keep in touch
kk	kiss kiss
kmp	keep me posted
koc	kiss on cheek
kol	kiss on lips
kotc	kiss on the cheek
kotl	kiss on the lips
kpc	keeping parents clueless
kutgw	keep up the good work
kwim	know what i mean
l	laugh
havin	having
watz	what's
wud	would
mayb	maybe
4eva	forever
enuf	enough
hapi	happy
gr&d	grand
l8	late
l8r	later
l8a	later
cld9	cloud nine
tru	true
tlkd	talked
tlk	talk
anytin	anything
frm	from
l8rg8r	later gator
lch	lunch
ld	long distance
ldr	long distance relationship
ldttwa	let's do the time warp again
lhm	lord help me
lho	laughing head off
lhu	lord help you
lifo	last in first out
lis	laughing in silence
lkit	like it
lkitr	little kid in the room
llta	lots and lots of thunderous applause
lmirl	let's meet in real life
lmk	let me know
lmso	laughing my socks off
lmtcb	left message to call back
lngtmnoc	long time no see
lnk	love and kisses
lol	laughing out loud
lola	laugh out loud again
lonh	lights on	 nobody home
lool	laughing outrageously out loud
lopsod	long on promises	 short on delivery
lou	laughing over you
lrf	little rubber feet
lshmbb	laughing so hard my belly is bouncing
lshmbh	laughing so hard my belly hurts
ltic	laughing till i cry
ltm	laugh to myself
ltr	long term relationship
lts	laughing to self
ltsgt2gthr	let's get together
lulu	locally undesirable land use
luv	love
luvu	love you
luwamh	love you with all my heart
ly4e	love you forever
lyb	love ya babe
lycylbb	love you see you later bye bye
lykyamy	love ya kiss ya already miss ya
lyl	love you loads
lylab	love you like a brother
lylas	love you like a sister
lylb	love ya later bye
lymi	love ya mean it
lyn	lying
m4c	meet for coffee
m8	mate
m8s	mates
skool	school
wz	was
plc	place
ma	mature audience
maya	most advanced yet accessible
mb	message board
mbn	must be nice
mbrsd	embarrassed
mc	merry christmas
md	managing director
mfi	mad for it
mgb	may god bless
mhbfy	my heart bleeds for you
mia	missing in action
mihap	may i have your attention please
mitin	more info than i needed
mkop	my kind of place
mlas	my lips are sealed
mm	market maker
mmha2u	my most humble apologies to you
mmyt	mail me your thoughts
mompl	one moment please
moos	member of the opposite sex
mop	moment please
morf	male or female
motas	member of the appropriate sex
motd	message of the day
motss	members of the same sex
mov	movie
msg	message
msulkecrz	miss you like crazy
mtbf	mean time between failure
mte	my thoughts exactly
mtf	more to follow
mtfbwu	may the force be with you
mtla	my true love always
mu	miss you
mubar	messed up beyond all recognition
musm	miss you so much
myl	mind your language
myob	mind your own business
n	and
n1	nice one
n2m	not too much
na	no access
nab	not a blonde
nadt	not a damn thing
nagi	not a good idea
nak	nursing at keyboard
nalopkt	not a lot of people know that
naz	name address zip
nbd	no big deal
nbif	no basis in fact
nc	no comment
ncase	in case
ncg	new college graduate
ne	any
ne1	anyone
ne1er	anyone here
ned	need
nesec	any second
nethng	anything
ng	new game
nifoc	nude in front of the computer
nim	no internal message
nimq	not in my queue
nimy	never in a million years
nm	never mind	nothing much
nmp	not my problem
no1	no one
noyb	none of your business
np	no problem
nqocd	not quite our class dear
nrg	energy
nrn	no reply necessary
nsa	no strings attached
nsfw	not safe for work
nt	nice try
nt2nite	not tonight
ntimm	not that it matters much
ntk	nice to know
nttawwt	not that there's anything wrong with that
ntymi	now that you mention it
nuff	enough
nufn	nothing
nvm	never mind
nw	no way
nwhl	in a while
nwo	no way out
o	or
o4u	only for you
oaus	on an unrelated subject
obab	oh baby
obtw	oh by the way
ocd	obsessive compulsive disorder
odtaa	one damn thing after another
oic	oh i see
ol	old lady
oll	online love
om	old man
omb	oh my buddha
omdb	over my dead body
omg	oh my god
oml	oh my lord
on4it	on for it
onid	oh no i didn't
onna	oh no	 not again
onnta	oh no	 not this again
ooak	one of a kind
ooc	out of control
oof	out of facility
ooi	out of interest
ooo	out of office
ootc	obligatory on topic comment
ot	off topic
otf	off the floor
otoh	on the other hand
otp	on the phone
ott	over the top
ottomh	off the top of my head
ova	over
owtte	or words to that effect
p2c2e	process too complicated too explain
pcm	please call me
pds	please don't shoot
pif	paid in full
pir	parent in room
pls	please
pls4givme	please forgive me
pm	private message
pmfji	pardon me for jumping in
pmigbom	put mind in gear before opening mouth
pmji	pardon my jumping in
pnd	possibly not definitely
poahf	put on a happy face
pona	person of no account
pos	parent over shoulder
pov	point of view
ppl	people
prt	party
prw	parents are watching
ps	post script
ptb	please text back
pth	prime tanning hours
ptmm	please tell me more
q	queue
qix	quick
ql	quit laughing
qq	quick question
qs	quit scrolling
qt	cutie
r	are
rad	radical
rbay	right back at you
rbtl	read between the lines
rc	remote control
rfd	request for discussion
rgds	regards
ringl8	running late
rip	rest in peace
rkba	right to keep and bear arms
rlf	real life friend
rmb	ring my bell
rme	rolling my eyes
rmlb	read my lips baby
rmmm	read my mail man
rofwivu	rolling on the floor with you
rotfl	rolling on the floor laughing
rotflol	rolling on the floor laughing out loud
rotfluts	rolling on the floor laughing unable to speak
rotgl	rolling on the ground laughing
rotm	right on the money
rsn	really soon now
rtbs	reason to be single
rtfaq	read the faq file
rtk	return to keyboard
rtm	read the manual
rttsd	right thing to say dude
ru	are you
wrd	word
clik	click
ovr	over
jst	just
transl8n	translating
wn2	want to
hre	here
transl8	translate
2c	to see
def	definitely
wrds	words
comin	coming
rucmng	are you coming
rumcymhmd	are you on medication cause you must have missed a dose
ruok	are you ok
rutlkn2me	are you talking to me
ruup4it	are you up for it
ryo	roll your own
s	is
s2r	send to receive
s4l	spam for life
sal	such a laugh
sbta	sorry being thick again
sc	stay cool
scnr	sorry	 could not resist
sec	second
sed	said enough darling
sep	somebody else's problem
sete	smiling ear to ear
sf	science fiction
sfaiaa	so far as i am aware
sfete	smiling from ear to ear
sfx	sound effects
shid	slap head in disgust
shopn	shopping
sis	sister
sk8	skate
sk8er	skater
slg	slag
smaim	send me an instant message
sme	subject matter expert
smem	send me e-mail
smmr	summer
smtoe	sets my teeth on edge
snafu	situation normal all fouled up
sohf	sense of humour failure
sol	sooner or later
somy	sick of me yet
sot	short of time
sotmg	short of time must go
spk	speak
sry	sorry
st2moro	same time tomorrow
str8	straight
stra	stray
stw	search the web
stys	speak to you soon
su	shut up
suakm	shut up and kiss me
sum1	someone
suyf	shut up you fool
swak	sealed with a kiss
swalk	sealed with a loving kiss
swdyt	so what do you think
swg	scientific wild guess
swl	screaming with laughter
sx	sex
sxe	sexy
sys	see you soon
t2go	time to go
t2ul8r	talk to you later
t4y	text for you
ta	thanks again
tafn	that's all for now
tah	take a hike
tanstaafl	there ain't no such thing as a free lunch
tas	taking a shower
tba	to be advised
tbc	to be continued
tcb	trouble came back
tcoy	take care of yourself
tdtm	talk dirty to me
tdtu	totally devoted to you
tel	telephone
teotwawki	the end of the world as we know it
tfds	that is for darn sure
tfh	thread from hell
tfn	thanks for nothing
tfx	traffic
tgif	thank god it's friday
thn	then
thnq	thank you
thx	thanks
tia	thanks in advance
tiail	think i am in love
tilii	tell it like it is
tink	think
tlgo	the list goes on
tlitbc	that's life in the big city
tmb	text me back
tmi	too much information
tmiy	take me i'm yours
tmot	trust me on this
tmtowtdi	there's more than one way to do it
tna	temporarily not available
tnc	tongue in cheek
tnt	till next time
topca	till our paths cross again
tpc	the phone company
tptb	the powers that be
tqm	total quality management
truluv	true love
tsia	this says it all
tsr	totally stuck in ram
ttbomk	to the best of my knowledge
ttfn	ta ta for now
tts	text to speech
ttt	that's the ticket
tttt	to tell the truth
ttytt	to tell you the truth
tul	tell you later
twhab	this won't hurt a bit
twimc	to whom it may concern
twiwi	that was interesting wasn't it
txt	text
txtin	texting
tyt	take your time
tyvm	thank you very much
u	you
u2	you too
u4e	yours for ever
u-l	you will
up4it	up for it
ur	you are
urhstry	you are history
urt1	you are the one
urws	you are wise
uryy4m	you are too wise for me
urzzz	you are boring
usp	unique selling proposition
uve	you've
uwot	you what
vbg	very big grin
vbs	very big smile
vfm	value for money
vgc	very good condition
vm	voice mail
vri	very
vsf	very sad face
w	with
w4u	waiting for you
w8	wait
w84me	wait for me
w8am	wait a minute
w8n	waiting
wadr	with all due respect
wai	what an idiot
wambam	web application meets brick and mortar
wan2	want to
wan2c	want to see
wan2tlk	want to talk
wassup	what's up
wayd	what are you doing
wayn	where are you now
wb	welcome back
wbs	write back soon
wca	who cares anyway
wckd	wicked
wdalyic	who died and left you in charge
wdr	with due respect
wdys	what did you say
wdyt	what do you think
weg	wicked evil grin
wenja	when do you
werja	where do you
werru	where are you
werubn	where have you been
wf	way fun
wfm	works for me
wg	wicked grin
whl	while
wibni	wouldn't it be nice if
wiifm	what's in it for me
wip	work in process
wisp	winning is so pleasurable
witw	what in the world
wiu	wrap it up
wk	week
wkewl	way cool
wknd	weekend
wl	will
wlubmn	will you be mine
wlumryme	will you marry me
wn	when
wnohgb	were no one has gone before
wo	without
womba	waste of money brains and time
wot	what
wrt	with respect to
wru	where are you
wruf	when are you free
wt	without thinking
wtb	want to buy
wtg	way to go
wtgp	want to go private
wth	what the heck
wtm	what time
wtmi	way too much information
wtsds	where the sun don't shine
wttm	without thinking to much
wuf	where are you from
wuu2	what you up to
wwsd	what would satan do
wwy	where were you
wx	weather
wycm	will you call me
wyp	what's your problem
wyrn	what's your real name
wys	whatever you say
wysiwyg	what you see is what you get
wyslpg	what you see looks pretty good
wyt	whatever you think
wywh	wish you were here
x	kiss
xclusvlyyrs	exclusively yours
x-i-10	exciting
xlnt	excellent
xme	excuse me
xmeqk	kiss me quick
xo	kiss and a hug
y	why
ya	yet another
yacc	yet another calendar company
yafiygi	you asked for it you got it
ybs	you'll be sorry
yct	your comment to
ydkm	you don't know me
yeppies	young experimenting perfection seekers
yg	young gentleman
ygbk	you gotta be kidding
yhm	you have me
yic	yours in christ
yiu	yes i understand
ykwycd	you know what you can do
yl	young lady
ym	young man
ymmv	your mileage may vary
ynk	you never know
yr	your
yrplcomn	your place or mine
ysyd	yeah sure you do
yttt	you telling the truth
yw	you're welcome
ywia	you're welcome in advance
yyssw	yeah yeah sure sure whatever
z	said
zzzz	sleeping
